文本;真实一级评论数;真实点赞数;边数;最大边数;集群密度
在上宏观经济学脑海里冒出主管几次和我说工作上有的是跟头让我跌（如果以我当下的思维一意孤行的话）陷入沉思耳边又响起老师的讲课声：先行经济形势严峻，疫情后消费水平下降，我有切身的体会，以往;1;0;1;10006;9.994003597841295e-05
中央金融工作会议在京举行，怎么解读每五年一次的的金融会议？年月，第一次全国金融工作会议。随后每五年一次，因为疫情去年的延后到今年，不过有意思的每次开完会，次年都是股市相对困难的年份。回顾最近一次，年月，第五次全国金融工作会议召开，会议提出了多项关键举措，以进一步发展中国的金融体系。首要任务是将直接融资发展放在重要位置，以建立多层次资本市场体系，确保融资功能完备、基础制度扎实、市场监管有效，投资者的合法权益得到有效保护。所以，我们看到了最近几年上市公司数量激增，可以说这一次会议定调的加速任务执行的很好。年月底这一次，提到了“清醒看到，金融领域各种矛盾和问题相互交织、相互影响，有的还很突出，经济金融风险隐患仍然较多，金融服务实体经济的质效不高，金融乱象和腐败问题屡禁不止，金融监管和治理能力薄弱。”很明显，融资加速后遗症太猛了，必须要治理了，说白了，已经达到乱象的地步，所以规范市场是主要基调了。玉名超话;7;21;28;10006;0.0027983210073955628
中新网专访盛智文：“夜经济”让更多人看到香港经济发展潜力香港在疫情后重新激活“夜经济”，往日的“不夜城”以何种方式重新回归，香港特区政府大力推动的“夜经济”，提供了哪些形式的“夜消费”平台？又如何通过推动“夜经济”与香港饮食文化等深度融合，为香港的城市发展注入新动能？被誉为“兰桂坊之父”的香港兰桂坊集团主席盛智文近日接受中新网港澳会客厅专访时作出解答。（记者戴小橦范思忆刘轩廷罗嗣昱梁源）;4;14;18;10006;0.001798920647611433
第届广交会第三期今天在广州琶洲馆开幕了，这是疫情后的第二届广交会，这届比上届的国外客商明显增多。我公司在农产品展馆参展，来摊位洽谈生意的中东地区的客户偏多。广交会是中国经济乃至世界经济的晴雨表，看着熙熙攘攘的客流，发展经济的信心增加了很多。;2;11;13;10006;0.0012992204677193685
疫情解封后进入第二年才算真正的恢复期的，不管是经济还是股市都是第二年才有起色。投入也会明显增大的。;1;70;71;10006;0.00709574255446732
我一直讲通胀也经常被人嘲笑但我坚持认为投资要有前瞻性而且很多时候，也不能仅仅看来确定有没有通胀大家还是要多从身边的，吃喝拉撒观察观察我主要预测错误在于，没想到疫情结束后经济表现如此的不如意也是出乎我的意料这是通胀被延迟的根本原因在中国通缩从来不需要担心通胀才是本质如果你没看懂哪说明你不懂国情跟其他大师学一句当然我可能是错的;4;40;44;10006;0.00439736158305017
经历了疫情的洗礼，经历了疫情后各方面的不顺畅，目前各行各业逐步的向好，经济面已经见底，下来见证经济的韧性面，迎接经济的增长。迎接股市的增长。各大蓝筹，各行业龙头公司。;3;18;21;10006;0.002098740755546672
疫情后各国央行们史无前例投放到金融市场的流动性以乘数效应急速增大，使得石油、粮食、黄金等商品价格疯狂上涨，去库进程被打断，但这也会最终加速美元泡沫的破裂，从而带动商品泡沫的破裂，使得世界经济陷入迅速倒退的危险境地。;1;13;14;10006;0.0013991605036977814
印尼不满电商平台上中国商品泛滥此前，印度尼西亚政府正式宣布，禁止社交媒体平台作为商品交易平台。这一举措直接冲击了平台上多万卖家和万电商内容创作者。据当地媒体报道，月日，印尼曾召开一场如何规范社交电商的会议。会上印尼智库“经济与金融发展研究所”（）建议政府修改贸易条例，并点名应对加强管制，理由是平台上“中国产品泛滥”，对当地企业“构成威胁”。这家智库的数字经济研究员表示，近年来印尼的电商产品从其他国家进口，中国产品占比尤高。但封禁电商、打击中国产品，并没有带来意想中的“实惠”。据半岛电视台报道，禁令过去近一个月后，印尼最大的纺织品市场丹纳阿邦并没有出现人流如潮的繁荣景象。相反地，与疫情期间相比，这里的客流量少了一半。（来源：环球网）;4;23;27;10006;0.0026983809714171496
中国抛售亿美债后，美债最大卖家浮出水面，竟然狂抛万亿美债“钱来如影随形，去得风驰电掣。”这不仅仅是对情感的描述，对于金融世界里的资金流动同样如此。有人说，跟踪资金流向，就能看清楚市场的真实面目。而今天我们要说的，便是有关中美之间的那块巨大的“蛋糕”：美国国债。大家可能已经知道，中国抛售了亿美元的美债，但在你还未从这笔数目的震撼中缓过神来时，更大的震撼却随之而来：美债的最大卖家，其抛售规模更是达到了令人瞠目的万亿美元。究竟是哪家力量如此之大，又有着怎样的背后考量？让我们先回顾一下，中国为什么会抛售亿美元的美债。近年来，中美经济、贸易关系时常成为各大媒体的头号消息。货币政策、贸易摩擦、全球经济的变化，都使得各国对于外汇储备和国际资产的配置进行了重新考量。为了优化外汇储备结构和应对不断变化的国际经济环境，中国选择了部分减持美债。而此举也与近年来人民币国际化战略，以及寻求更多元化的投资渠道不无关系。但当我们还在关注中国的抛售行为时，一个更大的玩家却悄然登场。这个玩家抛售了高达万亿美元的美债，规模是中国的近两倍。这便是日本。为何日本会有如此大规模的抛售动作呢？近年来，日本面临的经济压力与挑战日益增大。长期的通货紧缩和人口老龄化问题使得日本经济增长乏力。在此背景下，日本为了刺激国内经济，大幅度实施宽松的货币政策。而为了减少外部风险，它也选择调整国际资产配置，从而导致了对美债的大规模抛售。更为关键的是，日本希望通过这一策略，稳定日元汇率，以利于其出口导向型经济模式。再深入探究一下美债市场的现状。由于全球经济环境的变化，特别是疫情后的全球经济恢复，不少国家为了刺激经济增长，都选择了放宽货币政策。这导致全球流动性过剩，而美债作为全球最大、最安全的债务市场，自然成为了资金的首选归宿。但随着各国经济逐渐恢复，加之预期的通货膨胀压力，持有美债的吸引力也在逐渐减弱，从而导致不少持有者选择了抛售。我们不能仅仅看到抛售这一动作，还需要了解其背后的深层原因。从中美日三国的抛售行为中，我们可以窥见国际资本市场的流动性、信贷风险以及全球经济的复杂关联。而对于普通投资者而言，关注这些国际金融市场的动态，有助于更好地理解和应对市场的波动，为自己的投资决策提供有力的参考。金融市场的每一个动向，都是由无数个决策、考量和策略汇集而成。而在这个巨大的市场舞台上，国家和机构都是表演者，而我们作为投资者和观众，更应深入了解背后的故事。你觉得接下来美债市场会有怎样的变化？期待在评论区听到你的见解。;1;226;227;10006;0.02268638816709974
至今开始的通缩周期，会因为债务化解而消散。当然不知道能不能真的化解掉。通缩周期也有阶段，节点依然一样，和及两个周期没什么不一样。通缩前减债屯现金，通缩开始后找标的寻资产，通缩中期开始建企业，通缩后期开始收资产。通缩的时候一定不要屯现金，你会发现全世界解决掉通缩的办法几千年没变过，就是印钱。当你发现通缩周期一过，屯了一堆纸。经济这事儿没那么玄乎，目前就是陷入中等收入陷阱了，这个通缩周期就触发了，只是等到年才开始爆发显现出来，有没有疫情都会爆发，相对疫情还减缓了彻底爆发的情况。按部就班吧如果我呼吁的清欠经济措施能够政府完全采纳，就有望走出通缩。时间节点也简单，就今年年底和明年春节后月份。倘若没有这么做，就看政府还有其他大智慧没有了。;27;399;426;10006;0.042574455326803914
先评后转：是谁把房地产逼上了绝路？有人说是后，这是没话找话说，后还没到买房的年龄，他们就是有意愿，也得看为他她付钱的家长。房地产目前处于困境是事实，和房地产一起陷入困境的是疫情后急待复苏的中国经济。大势、城市、楼市困难叠加，一起在影响着房地产行业的发展，不要嫁祸于无辜的后年轻人。后有的还在读书，有的刚走上工作岗位上，此刻逼他们买房就是強其所难转：是谁把房地产逼上了绝路？估计房地产界做梦都没有想到今日头条网页链接;5;7;12;10006;0.0011992804317409553
我实在无法认同一些专家的观点，他们认为，股市长期徘徊于点，主要是因为投资者对中国经济的信心不足，认为中国经济不可能在较快的时间内，出现一个比较明显的实质性增长。还有一个原因是美国不断加息，导致美债利率上行，许多人认为投资美债还是一个不错的原因。我重点谈一下专家的第一个观点。股市围绕点进行反复的震荡已经有十多年的时间了，在这期间，经济增速在以下的时候，股市不涨，难道也是因为对经济增长没有信心吗。还有疫情三年期间，市场明显对经济增速很担忧，虽然市场没有大涨，也没有坏到哪里去，偏偏在今年疫情全面结束后，各种稳增长的政策出台后，股市的走势让人感到前所未有的绝望，难道真的是投资者对未来的经济增长没有信心吗。就算是投资者对未来经济增长的信心不足，这绝不是来自投资者的内心。首先是不断公布的经济数据显示经济增长不理想，再说了，如果经济增长前景向好，也用不着进行不断的刺激。而对于我们普通投资者而言，你完全可以从发生你身边的一些事情来判断对经济增长的好坏。无论是数据还是自己的真实感受，都传递出经济增速前景不乐观的预期，你又凭什么对未来有信心呢。信心不足绝不是因为你内心悲观，如果明明经济增速不乐观，如果你信心满满，那岂不是不切实际的盲目乐观。信心不足才是实事求是的表现。至于股市长期扩容，制度的不公，各种违法违规压垮了市场，他却视而不见。股市走成这个样子。每个投资者心里很清楚，绝不是因为你对经济增长没有信心，所以才导致大家抛售股票。这种原因只是股市长期走熊的阶段性的原因，也是很小一部分原因。经济再好，企业再盈利，也经不起越来越多的大扩容，经不起不公平的交易制度下被人宰割的命运。;3;105;108;10006;0.010793523885668599
好多人啊跟一堆哥哥姐姐们聊天（他们都是几后有经济能力去很多地方看过好多演出聊起疫情前疫情后看过的各类演唱会而疫情的我还是个需要父母带着看演唱会的小孩现在我也长大啦不过很搞笑他们问我后是怎么跟他们一样听郭静的很不解然后是帅的吸引我目光的乐手戳泡泡的郭静好美好礼貌好温柔可惜合照没多看她几眼见到真人还是会紧张字幕真的做的很可爱好喜欢;-2;5;3;10006;0.00029982010793523883
张庭传销案被撤销法理可恕，天理难容自从进入后疫情时代，经济困顿，民企营商环境恶化，信心不足，移民的移民，躺平的躺平，收监的收监。就业环境遭遇历史最难境地，大水漫灌收效甚微。民众信心受挫，拖累经济复苏。然后，然后开始对民企松绑，宽恕宽大更加宽容，政策层出不穷。好像犯了错也可以既往不咎，一切从宽处理。就连这祸害了无数人的张庭传销案也撤销了，资产冻结也解封了。他们自由了，可怜那些被他们坑害的人。他们的公道呢？谁来负责？有钱人就该宽恕，没钱人自认倒霉吗？那天理何在？正义何在？为了经济，我们真的可以不择手段，毫无底线吗？多年来，唯利是图一切向钱的风气已经让我们整个社会付出了巨大代价，现在一切偏向有钱人的做法还将毒害更多人吗？非要等民心向背，悲观绝望后才要彻底醒悟，后悔今天的决策吗？这种案例，和全世界跪舔有钱的犹太人有什么区别？正义真的没有金钱更重要吗？天理何在？良知何在？;3;5;8;10006;0.0007995202878273036
疫情三年我们曾以为疫情结束后，一切会逐渐恢复正常，但经济复苏却遥遥无期，消费市场几乎停滞不前，各行各业都陷入困境。过去的三年对全球经济造成了巨大的冲击。疫情导致许多国家实施了封锁和限制措施，这对消费市场产生了严重的影响。很多企业不得不停业或缩减规模，导致失业率的上升和经济活动的停滞。此外，全球供应链也受到了严重的干扰，导致物资短缺和商品价格的波动。国家仍然面临着病例增加和新的变种病毒的威胁，这可能导致进一步的限制和不确定性，阻碍了经济的恢复。此外，消费者信心的恢复也需要一定的时间，因为人们仍然对未来感到担忧，对支出持谨慎态度。在这个时候，各行各业需要灵活应对并寻找新的发展机会。政府可以采取财政和货币政策来刺激经济，支持企业和个人。同时，企业可以加强创新，调整经营模式，寻找新的市场和业务机会。对于个人来说，继续提升自己的技能和能力也很重要，以适应不断变化的就业市场。虽然经济复苏的时间线不确定，但我们相信通过全球共同努力，我们最终能够渡过这个难关，重启经济，并逐渐恢复正常的生活。;1;0;1;10006;9.994003597841295e-05
朋友们，《富贵》就要来了。今年很特殊，疫情三年万业待苏，大家很煎熬，也很吃劲。疫后这一年，叔走了好几个省事，大城市到县乡，都有涉及，有一些想法。大致富贵这一季准备写几个话题，不想在像过去那样，试图把宏观到企业行业，国内到国外都说一边。就说一些具体的问题。一是县域经济。这个话题年写过，现在看有必要再说一说，变化很大；县域经济可上可下，目前面临选择；二是经济发展的成本率，也就是叔经常说的成本，现在这个问题很突出，、企业、居民都有，有些部分陷得很深，也是目前踩油门打方向，依然效果不彰的主要原因之一；三是统一市场的意识，这个认识过去已经在很大程度上解决，现在似乎又迷糊；嘴上说得有理有据，但是做起来并没有真正的尊重市场。希望能从要素市场、从某些行业去说这个问题。肤浅的、初始的出厂设置，往往是最大。大家有什么意见，也可以留言。争取在春节前完成所有章节。;3;41;44;10006;0.00439736158305017
站疫情期间有个很火的视频，好像叫：去摆摊吧后浪纪念一下摆摊经济。;0;0;0;10006;0.0
凡是喊“三年疫情导致经济崩溃”的都是靠名词嫁接来颠倒黑白污名化的。只有第三年开始失控，因为：卫健委打开了对外大门，但又对内加严（并且医保资金在疯狂的浪费掉）。头两年外贸都赚疯了，两趟賺一条船回来。美国在年初开启了加息收割之路。这个喊了小两年了，也说了，放开后经济也没变好展开;3;3;6;10006;0.0005996402158704777
凡是喊“三年疫情导致经济崩溃”的都是靠名词嫁接来颠倒黑白污名化的。只有第三年开始失控，因为：卫健委打开了对外大门，但又对内加严（并且医保资金在疯狂的浪费掉）。头两年外贸都赚疯了，两趟賺一条船回来。美国在年初开启了加息收割之路。这个喊了小两年了，也说了，放开后经济也没变好时，大家才会发现疫情不是经济变差的主要原因（那时没想到未来还有故意改变记忆来污名化过去的。）恶心这群人的美爹又又又快破产了，数据假的离谱，银行都准备雷成烟花了，还美滋滋学他们说话呢。;3;3;6;10006;0.0005996402158704777
香港政府财政状况再亮起红灯。当局承认，疫情后，香港经济复苏的速度低于预期，预料财政赤字可能超过一千亿港元。有财经界人士担心，若香港财政储备进一步恶化，将动摇运作了四十年的联系汇率制度。;1;4;5;10006;0.0004997001798920647
陈茂波：香港疫后复甦速度较想像慢料赤字逾千亿今年外围经济环境不好，香港在疫情后全面复甦的速度亦比想像中慢，今年的卖地收益及印花税收入少，预计财政赤字会比财政预算案估算的高，有可能超过千亿元网页链接;1;1;2;10006;0.0001998800719568259
最近经常听到的一个词是“阵痛”。后疫情时代的阵痛，裁员潮的阵痛，系统整顿的阵痛，经济形势低迷的阵痛。从庞大社会体系传来的动荡蔓延到个人身上，最强烈的第一直觉似乎不是痛感，是迷茫。就仿佛是，跋涉很久才后知后觉黄金时代已经过去，却不知道下一个欣欣向荣的时代什么时候才会到来。;1;15;16;10006;0.0015990405756546072
平安保险，我买了份，由于疫情，经济情况不好，退保了，才发现损失了还多，投诉了以后，平安以我同意退保为由不予处理，但问题是，如果一直有能力交还真不知道会这么高的所谓费用，如果不是疫情之下，我努把力交满这些保险，平安不要高兴跳，但年后，他们拿什么钱来支付所承萿诺的理赔，平安人寿;4;4;8;10006;0.0007995202878273036
山东经济韧性从何而来在闯过前一轮改革的阵痛期、经历了三年疫情的冲击后，山东表现出的经济韧性令人眼前一亮，放在绿色低碳高质量发展的标尺下，的增幅背后所体现出的转型意志和决心或许更值得探究。;-1;22;21;10006;0.002098740755546672
在闯过前一轮改革的阵痛期、经历了三年疫情的冲击后，山东表现出的经济韧性令人眼前一亮，放在绿色低碳高质量发展的标尺下，的增幅背后所体现出的转型网页链接;3;4;7;10006;0.0006995802518488907
一觉醒来又在想，每个人都在卷，我躺这么平真的合适吗说真的为什么今年大家都大卷特卷起来了，是因为后疫情时代经济不好了吗;1;4;5;10006;0.0004997001798920647
经济日报金观平：透过短期之“形”把握长期之“势”财联社月日电，经济日报发表观点评论文章，疫情防控平稳转段后，我国经济恢复是一个波浪式发展、曲折式前进的过程。在恢复过程中，一些领域出现暂时性波动是正常的。如果仅凭局部、短期的波动数据来判断全局，难免会以偏概全，甚至对我国经济走势产生误判。形势越复杂，越要坚持用全面、辩证、长远的眼光看待我国经济，既看增速也看结构，既看国内也看国际，既看当前也看长远。透过短期之“形”，把握长期之“势”。;13;25;38;10006;0.003797721367179692
疯狂小杨哥怒怼李佳琦价格垄断李佳琦被攻击越多讨论越多，直播和电商行业就越繁荣。以及最近也上热搜的大小杨哥。而且大杨哥和李佳琦还撕起来了。他们被关注越多，越说明零售业没啥事干，热点都在直播和大上。最后骂大越起劲，实体商业越萧条。当然李佳琦不可能垄断，即使有这能力也会收敛。关键是主播会层出不穷，直播生态会持续繁荣。另外，像真假和田玉、定价等问题，越是曝光多，也越说明线上商业的未来越好。不是说没问题，现在肯定各种问题，而是说趋势上，因为线上这个生态的透明度和长期做生意的需求，随时会纠偏，或者同行来捶你。线下买假和田玉的概率我看要高得多。线下只能找熟人，而线上有能力建立起陌生人之间的信用体系。实体商业不好干已经很多年了，这两年更甚。疫情期间熬，放开后不能再拿疫情当甩锅对象，李佳琦和小杨哥就成了甩锅对象。前些天印尼禁直播带货，咱这边也跟着传言要禁直播带货。不可能的。而且预个言：印尼最后也得放开。总统也没法跟需求作对，跟市场作对。去年双十一市监总局已经放话：线上销售也是实体经济。为啥？因为电商和直播带货很大一部分带动的是增量，不只是挤压存量。包括就业和商品零售量。而且从来没有挤压制造业，只是挤压线下渠道。但是如果把直播带货关了，这里面的很多销售量不会回流到线下去逛街购物。消费场景和心态都不一样。做标准化商品的线下实体店，比如电子、服装，会越来越难的。骂直播带货和头部主播，真的解决不了自己的问题。最后本质上是个话语权在什么环节的问题。早期物资紧缺的时代，谁有货谁是老大，要批条才有彩电；生产跟上来之后，连锁商超更强势，苏宁国美说压价就压价；再往后是互联网大平台的时代，掌握流量支配权；现在是直播兴起后的娱乐流量压倒其他一切，连企鹅的社交流量都被薅去了。个体力量和平台力量分庭抗礼。否则平台的话语权会更强。不过这都是线上生态越来越丰富的表现，跟线下其实没关系。华为的已经来了，的交互场景也不远了。聪明的线下店主早就拥抱互联网了，其实就是拥抱用户。可别成天骂娘了，骂来骂去用户都跑了个球的。疯狂小杨哥回应电商挤压实体经济王海打假李佳琦直播间卖和田玉;1;19;20;10006;0.001998800719568259
桥基认为，两因素将继续对期利率施加上压、对经济施加下压：）在重要经济指标稳定在预期平之前，有必要实紧缩性的货币政策；）债券市场出现的流动性缺。关于货币政策的影响，经济增平还不够疲弱，不以撑通胀平下的降息。在这种情况下，正确的对策是将短期利率致保持在当前平，或者将其进步幅上调。前的情况是市场这只“形的”正在发挥其配置量。通常，经济形势的变化是利率和资产价格变化的最驱动因素。在本轮紧缩周期的前两波出、经济增速和通胀率先升后降即是如此。进紧缩周期的现阶段，最重要的是各形势是否已达到预期平截前，还没有。经济形势平与决策者的预期平之间存在失衡，其影响在第三季度开始显现。考虑到）通胀平仍略微过；）资增速过，法使通胀率稳定在标范围内；）劳动市场形势过于强劲，法给资带来下压；）实际经济增速还不以撑政策放宽，市场认为恰当的货币政策反应是，将短期利率保持或提于当前平。鉴于债券收益率平远低于这平，债券收益率需要上调，我们认为这是紧缩周期下阶段的开始。展望未来，如果短期国库券利率保持在或更，中期国债收益率需要达到或更以补偿险溢价。由于国债供给在增加央退出购买，需要私营部投资者来撑债券需求，这些投资者将寻求相对于现的险溢价。关于债券市场正在出现的流动性缺，美国政府的期债券发量即将升常的平，远超现有的购债需求。此前，财政部通过短期国库券为其巨额财政字提供资，购买国库券的需求则来宽松货币政策下的过剩资；这使得流动性缺的影响被延后了。未来，政府将转向发期债券，过剩的流动性将逐步减少，直不复存在。这将使私营部投资者成为主要的需求端量，其对债券的需求直以来都远低于未来供给。三季度的债券发量明显上升时，债券已经开始出现抛售。市场势能清楚表现紧缩周期进了第阶段。在紧缩周期初期，短期利率上升，并推动期利率。这种情况从年开始，持续了年之后出现了段缓和期。短期利率继续上升，但期债券收益率横盘交易，反映出市场对未来宽松政策的预期，同时美国财政部通过发短期国债来规避期利率的压。如上所述，在第三季度，这两种形势都发了变化，开启了以期利率上升为主导的紧缩周期的下阶段。虽然第轮紧缩周期是通过债市发的，但其影响远远超出了债券市场。就经济，我们认为短期利率和期利率期处于位，应该会给经济增带来期持续压。随着宽松政策落地的推迟，与过去年较低的实际利率相，当前的实际利率平已经幅降低了借款和提杠杆率的动机。信贷系统够健康，因此信贷急剧萎缩不是最可能出现的结果，但利率平期持续处于位，将缩利率平和经济增平之间的差距（改变了提杠杆率的效益），并在定程度上导致借款将收于偿债出，因为现有债务将以更利率进再融资。就股票，随着债券收益率上升，股市相对于债市变得更加缺乏吸引，这增强了现利率对险资产的负影响。值得注意的是，今年主要撑股票市场的因素，直是险溢价的收缩，这主要得益于流动性问题的缓解和很快降息的预期。但前看，我们不能依赖于现利率下降来恢复股票相对于现的险溢价，因为前的形势并不撑降息。考虑到经济增临期压且紧缩政策阻碍信贷加速增，盈利增将难以恢复股票相对于债券的竞争，因为盈利更有可能成为拖累因素。相反，要恢复股票相对于债券的险溢价以及债券相对于现的险溢价，可能需要更的利率和更低的价格平。前流动性动态正在发变化，这是启动这进程的推。就美元，由于经济保持强劲，前仍需采取紧缩政策，这对美元起到了撑作，但这种强劲在很程度上已被定价。未来存在很多不确定性，如果紧缩政策确实影响到经济增和资产，其净效应可能会变成对货币的不利影响；与此同时，美元临的期前景较弱，因为实际汇率处于数年的位，贸易逆差较，美国财政部规模发债，这可能会导致国际收失衡，从给美元和债券收益率带来压。全球范围内，随着紧缩周期持续进展，各国差异愈发扩：美国、欧洲、英国、澳利亚和加拿的紧缩压不同；中国和整个亚洲的期及周期性形势不同。这种分歧也泛存在于幅收紧的、和没有收紧的新兴市场之间，以及各经济体的汇率、股票和债券的定价不同等。因此，在这种环境下，相对价值交易（套利策略）和美元货币交叉汇率交易是些较好的机会。我们将在下详述这些差异。最的未知因素与智能和型语模型的技术突破对产率的影响。如果说，产率即将幅持续提，那么当前的定价可能是合理的。在这种情况下，当前的资平可能意味着未来通胀率会降低，并且预期的盈利增将更合理。由此，实际利率平可以保持位、并对经济影响较。期利率仍需上升，才能在新的均衡平为短期利率提供险溢价，但经济和股票市场将更容易承受这些利率变化的影响。各经济体的形势和资产价格愈发不同在美国，实际经济增仍具韧性，因为规模财政宽松政策使家庭在借款减少的情况下也能继续出。通胀率有所下降，更接近美联储的标，但仍然过。经济增仍具韧性，加上劳动市场处于紧俏状态，可能会使通胀从当前平再次。与此同时，随着量化紧缩持续和债券发量回升，债券的供需失衡愈发加剧，这意味着美国的流动性缺可能最严重。英国和欧洲临着更加困难的滞胀局。通胀率进步于标平，经济增乏、接近于零。两个经济体的通胀率都过，在劳动市场紧俏和会要求加薪的撑下，资正在迅速上涨。决策者努在保持政策紧缩的同时避免出现经济幅收缩。通胀率于预期平的时间越、距离标平越远，选择就会变得越紧迫，经济衰退就越可能成为必经之路。欧洲的市场定价与美国不相同。欧洲央设定的利率较低，其动已落后于紧缩周期。股市已经预期欧洲的经济增将幅放缓，欧元具有吸引。本正处于周期完全不同的阶段。疫情后重新开放的速度较慢、财政宽松的幅度较，这意味着本的失衡没有其他地那么严重。这使得本央能够在很段时间内维持宽松政策。最近，随着通胀率稳定在标平（或略），决策者的反应是逐步取消超宽松政策。步伐的调整直较缓，因此我们看到市场势表明宽松政策不可持续，其特点是端利率主导的利率上升和疲软的汇率。这需要本政府加快政策的转变速度，这可能使债券收益率加速上升、以及元幅反弹（从历史上看，元很容易出现这种情况）。股票估值仍具吸引，但与今年早些时候相有所下降。中国正处于期去杠杆化过程中，并且临些地缘政治的压。疫情后经济增开始复苏、但随后放缓，同时决策者正在将经济向消费驱动型增模式转型。总体，经济增仍低于预期，因为房地产部的债务负担仍然是拖累，就业增温和，储蓄率上升。低通胀率意味着政策可以保持宽松，但截前刺激措施度有限，因为政府优先考虑去杠杆和避免其他部过度借贷。展望未来，我们预期中国的政策将保持审慎宽松。尽管如此，股市、债市和汇市似乎都已经充分预期了险的上升和增的放缓。在其他新兴市场，美元紧缩的影响峰可能已经过去。与此同时，新兴市场之间存在巨差异。拉美经济经历了幅紧缩，并即将从全球供应链的重组中受益。亚洲新兴经济体受中国经济影响更，总体增放缓、但通胀问题要得多。新兴欧洲市场正在通过收紧政策以应对极的通胀。;1;8;9;10006;0.0008994603238057165
支原体大流行（早在今年月院长问我们想写的论文题目是什么，我说“大疫情时代下的经济”他问“什么是大疫情时代”我说“因为新冠感染后的免疫能力下降导致的各种流行传染病共同流行”他说我不懂生物;1;1187;1188;10006;0.11872876274235458
转个基本面分析，找翻译的，我修改了下不通的部分，凑活着看。由于疫情，数万亿美元的财政刺激和向家庭大撒币，这一股票市场周期变得非常棘手所有这些都对经济和资产价格产生了重大影响。、空前的、美联储的鸽派评论和大撒币在年创造了一个史诗级的资产泡沫，该泡沫在年晚些时候破裂。这是意料之中的。然后，随着美联储在年加息并开始进行，股票急剧下跌，最具投机性的名字受到了最大的冲击这也是意料之中的。现在我们来到了复杂的部分年秋季，英格兰银行对国债市场危机的回应为系统注入了流动性，这与美国总统周期的最佳个月期开始时间相吻合（年月年月）。当时，美国的通货膨胀率开始朝着正确的方向发展，经济保持强劲，季节性成为了股票的强劲顺风。为了进一步复杂化泡沫后的收缩，大约在同一时间，走红，对的乐观态度重新点燃了市场热情。基于上述因素，纳指在去年底触底，大型科技股七巨头开始崛起。今年早些时候，美联储为应对地区银行危机注入的流动性进一步推动了这一波动，并在美国总统周期的最佳个月期间（年月年月），与相关的股票呈现出抛物线上涨。值得注意的是，在此期间，大多数股票并未大幅上涨，这并不是新牛市开始标志。在年上半年，美国的债务上限僵局也帮助了流动性状况，并推高了股票，因为美国财政部的总账户的减少帮助抵消了美联储的资产负债表的减少。到了年中，达成了债务上限协议，美国财政部的大量新供应进入市场，开始从系统中吸取流动性。在月初，下调了美国政府的债务评级，这使得债券收益率上升，并进一步加剧了美国国债的抛售。所以，现在我们处于一个债券市场已经基本调整，但股票市场（至少在指数层面）仍然较高的情况。毫无疑问，大多数股票已经受到了一些损失只需看看零售商、公用事业等它们今年迄今都是平的或下跌的，其中一些处于周低点但是七巨头仍然支撑着。在投资业务中，没有什么是确定的，但历史表明，当整个市场大部分股票变得极为疲软时，最硬的大盘股也开跌，并拉低主要指数。在经济方面，多种几十年来非常可靠的领先指标暗示，硬着陆正在敲门，信贷周期的丑陋部分即将到来。根据我的研究，年的严重衰退是可能的结果，如果这一切发生，股票的上升空间相当有限。股票目前被大量抛售，因此在第四季度的某个时候，我们可能会看到一个死猫跳，但如果几十年的历史是任何指引，股票的下一个主要方向将是向下。这是因为考虑到无风险利率，估值仍然非常高，华尔街仍然为明年的增长做好了准备，在衰退期间，收益急剧下降，倍数也收缩，这就是为什么在接下来的个月内，股票可能面临大规模抛售的真正风险。在我看来，商业信贷周期并没有死它只是由于后刺激而被拉长，一旦过度储蓄消失，美国消费者将不得不应对非常高的利率，创纪录的信用卡债务和低个人储蓄率，我们也可能会看到一波公司违约。接下来的个月对经济和股票市场来说可能会非常棘手。与崩盘后的近期股票市场周期不同（这发生在一个通货紧缩时代），在这个周期中，由于高通胀和声誉风险，美联储可能会长时间保持高利率不变，而且它会不情愿地降息；这增加了即将到来的经济和股票市场低迷的风险。年期的收益率目前为，考虑到地平线上的风暴云，这似乎是一个不错的选择。;7;37;44;10006;0.00439736158305017
虽说疫情后经济很难，不过身边人陆陆续续搬新家了，顺带感受了一下新屋的喜悦这个年纪，大家慢慢稳定，各自有自己的家庭，感受生儿育女的甜酸苦辣。朋友也比较难聚在一起了，但忙忙碌碌下依然有着联系。年快来了，希望每年的自己都有成长，继续热爱生活啊小王;1;4;5;10006;0.0004997001798920647
为什么选择这个时间点增发国债？财政部回应有记者提问，为什么选择这个时间点增发国债？官方是否认为当前的经济形势比年新冠疫情暴发时更严重呢？对此，财政部副部长朱忠明日在国务院政策例行吹风会上表示，我理解，这位记者关心的是这次增发万亿元国债是不是作为提振经济的重大举措。今年以来，在以习近平同志为核心的党中央坚强领导下，我国更好统筹国内国际两个大局，更好统筹疫情防控和经济社会发展，更好统筹发展和安全，国民经济持续恢复、总体回升向好。特别是三季度以来，整体回升的态势更趋明显，多个领域出现了一些积极变化。这次增发万亿元国债的主要目的，是落实中央政治局常委会会议的部署，支持灾后恢复重建和提升防灾减灾救灾能力的项目建设，是补短板、强弱项、惠民生的重要安排。当然，国债资金投入使用后，客观上也会有利于带动国内需求，进一步巩固我国经济回升向好态势。;1;2;3;10006;0.00029982010793523883
财政部回应此时增发国债为什么选这个时间点增发国债？财政部回应有记者提问，为什么选择这个时间点增发国债？官方是否认为当前的经济形势比年新冠疫情暴发时更严重呢？对此，财政部副部长朱忠明日在国务院政策例行吹风会上表示，我理解，这位记者关心的是这次增发万亿元国债是不是作为提振经济的重大举措。今年以来，在以习近平同志为核心的党中央坚强领导下，我国更好统筹国内国际两个大局，更好统筹疫情防控和经济社会发展，更好统筹发展和安全，国民经济持续恢复、总体回升向好。特别是三季度以来，整体回升的态势更趋明显，多个领域出现了一些积极变化。这次增发万亿元国债的主要目的，是落实中央政治局常委会会议的部署，支持灾后恢复重建和提升防灾减灾救灾能力的项目建设，是补短板、强弱项、惠民生的重要安排。当然，国债资金投入使用后，客观上也会有利于带动国内需求，进一步巩固我国经济回升向好态势。我国将增发万亿元国债;2;8;10;10006;0.0009994003597841295
月日，十四届人大六次会议闭幕，四季度的弹药终于到位了，也拉开了中国经济反击的冲锋号。本次会议通过了万亿的中央国债增发，也通过了地方万亿的新增地方债提前下达。从四个角度看一下这次经济的冲锋号。一、万亿特别国债。按照年初的财政与孙，地方一般公共预算支出亿元，增长，而实际今年前三季度的仅支出亿元，同比仅增长。原本今年的财政预算就故意留到了四季度，让四季度的地方一般公共预算支出的同比增幅为。此次万亿特别国债要求亿花在今年的四季度，意味着四季度的地方一般公共预算支出的同比增幅将爆涨至，中国将迎来一个跟今年风格完全不同的四季度。二、万亿地方债。哪怕是全球疫情大流行的年，欧米克隆大爆发的年，中央提前下达的专项再限额都不足上一年的，只有疫情爆发之初的年，才将提前额度升至。时隔两年，中央将年提前下达的专项债限额再次提升至，也就是万亿（一般债亿元、专项债万亿元），标志着中国将再次以疫情爆发之初的财政力度来刺激经济。三、的债务上限。按照国际上通行的《马斯特里赫特条约》，政府赤字率一般设置为，中国历来也是将赤字率控制在以内，即使年疫情爆发，也只是按照安排。本次万亿国债将年的全国财政赤字率从一次性逼近到，超越了疫情的年，标志着中国本次是铁了心的要刺激经济了。甚至不排除，明年也将把赤字率的上限从继续调高至。四、四季度万亿债务总额。本次万亿特别国债中有千亿将在今年四季度使用，叠加年的地方债提前下达，共计万亿。这意味着本轮会议为四季度带来了万亿的新增资金，使得中国政府将在今年的四季度，瞬间成为了全球最富裕的“地主老财”。而伴随本次全国人代会将着债务上限的打开，中国进口和出口的市场也在同步打开。就在本次大会的期间，中国最主要的资源进口国，澳大利亚宣布，结束了对达尔文港项目安全审查，并称与中方世贸争端案达成共识，总理阿尔巴尼斯将于月日至日访问中国。这意味着，澳洲丰富的煤炭铁矿石，将成为中国新一轮基建的燃料，跟刚刚来访一带一路的新兴资源国，一起竞争中国的超级订单。搞定了原材料，自然还要为强劲的中国制造开拓市场。伴随着今天两个国委的官宣，中国的对外战略进入了新阶段，外交部和财政部也官宣了两个重磅的消息。月日，中美经济工作组以视频方式举行第一次会议。双方就两国及全球宏观经济形势和政策、双边经济关系、合作应对全球挑战等议题进行了深入、坦诚、建设性的沟通。月日，外交部发言人毛宁宣布：应美国国务卿布林肯邀请，中共中央政治局委员、外交部长王毅将于月日至日访问美国。大军未动，粮草先行。就像以色列大军集结后，迟迟未能进军加沙，背后是美国的国会迟迟未能批款，中国今年以来经济与就业压力骤增，也是因为人大并没有给予地方政府疫情期间那样充裕的弹药。如今，随着人代会将万亿的新增资金批复于四季度，中国的经济刺激行动的帷幕也正式拉开。中澳的会晤，为中国的经济刺激行动提供廉价的原材料，中美的会晤，为中国的经济刺激行动提供广阔的市场。国家将原材料和市场的问题先后解决，接下来就交给市场和全球最具竞争能力的中国企业。伴随着被特朗普打破的全球贸易循环被修复，政府调集资源全力刺激，国内的各项经济数据也将迎来一波强势的反弹，我巍巍中华也将在接下来一片昏暗的全球经济中大放异彩。;6;84;90;10006;0.008994603238057166
回答下，你们关心的一万亿和汇率的问题。并不存在一放水汇率就贬值这种逻辑。汇率是两国实际利率的比价。而实际利率是一国产出缺口的表征人民币持续的贬值是由于疫情后，米国的经济增速现实持续高于其潜在经济增速。而国内的情况正好相反。这就是人民币贬值的基本面。如果这个经济状况得到纠偏，汇率的压力也就得到了改善。所以，关键还是我们如何改善经济。这个不能靠统计局的数字。当下的数据美国三季度的会来到左右。这应该是它最高光的时刻。未来肯定是要回归潜在经济增速的而中国的经济，触底反弹也是确定的不确定的是：我们不知道反弹的动量有多大。但这依然可以得出结论：人民币的汇率在月份以后并不存在贬值的压力。;3;39;42;10006;0.004197481511093344
年眼看要过去，对我来说，好像真的是并不开心的一年。虽然因为疫情结束，出去旅游的确实很疯狂。也算是实现了我疫情后期发愿，希望疫情结束疯狂旅游的愿望。但是因为经济不好，或者行业不好，或者公司发展的原因，我这一年的工作确实很动荡（或者我觉得动荡）。观望了各种各样的工作机会，最终展开;0;1;1;10006;9.994003597841295e-05
最新财新周刊经济改善超预期最新财新周刊经济改善超预期在二季度中国经济增速低于预期后，市场一度担忧年初《政府工作报告》提出的左右的增长目标能否实现。三季度经济数据出炉后，这一担忧被打消。国家统计局月日公布的数据显示，经初步核算，年三季度国内生产总值（）同比增长，增速低于二季度个百分点，但明显高于财新调查的的预测均值。国家统计局副局长盛来运在月日的国新办发布会上表示，三季度同比增速较二季度回落，主要是因为年对比基数抬升。年二季度受疫情冲击比较大，当季同比增速只有，当年三季度回升到，如果扣除基数影响，年三季度两年平均增长，较二季度加快个百分点。他强调，看经济回升，除了看同比增速变化，还要看环比。统计局公布的三季度季调后环比增速为，比二季度加快个百分点。“从三季度的情况来看，经济恢复向好总体回升的态势更趋明显，多个领域、多项指标都出现了一些积极变化。”在这些积极变化的带动下，前三季度累计，中国同比增长，较上半年回落个百分点。“经济下行压力最大的时刻已过。”粤开证券首席经济学家罗志恒这样概括当前经济形势。考虑到年四季度基数较低，市场普遍认为，年实现左右的增长目标难度不大。盛来运称，四季度只要增长以上，就可以保障完成全年左右的预期目标。数据发布后，部分机构上调了对年全年中国经济增长的预期，比如野村从上调至，瑞银从上调至。;4;29;33;10006;0.0032980211872876276
日本将跌至全球第四预测日本将被德国反超，跌至全球第四综合美国彭博社、日本共同社月日报道，得益于日元对美元和欧元的贬值，德国预计将在年取代日本，成为世界第三大经济体。国际货币基金组织（）近日预测，年日本的名义国内生产总值（）将从全球第三跌至第四，被德国反超。公布的经济预期数据显示，年日本名义约为万亿美元，较上年下降。另一方面，德国增长，名义约为万亿美元。日媒称，日元贬值导致换算成美元后的缩水，此外名义受物价变动影响，德国比日本更高的物价涨幅也将在排名中得到反映。根据日本央行数据，年东京外汇市场日元兑美元平均汇率为美元兑日元左右，近期大幅贬值至日元左右；与此同时，欧元兑美元汇率的变化程度不及日元。物价涨幅按月来看，年日本大致维持在同比上方；另一方面，德国年初达到左右，之后慢慢减速，到月为上方。日媒坦言，受汇率影响较大，实际排名将受到年底之前的汇率动向影响，但日本的经济低增长已是长期持续现象。经济规模与国际影响力挂钩，一旦被德国赶超，日本的存在感将进一步下降。日，日本经济产业大臣西村康稔在被问及的预估结果时承认，日本的经济增长潜力确实已落后，且保持低迷。”他称，“我们想夺回过去二三十年的失地，并且希望通过即将出台的一揽子计划等措施实现这一目标。”日本首相岸田文雄日称，经济刺激方案包括延长能源补贴，旨在帮助缓解日本几十年来最严重通货膨胀造成的生活成本危机。而美媒分析称，日元疲软在很大程度上是由各国货币政策的根本不同造成的。美联储和欧洲央行已将利率从疫情期间的低点不断上调，以应对通胀。而日本央行在经历了多年的通缩后，货币政策仍保持刺激模式，想借此推动价格增长。美联储和欧洲央行预计将在即将召开的会议上保持利率不变。外界同时猜测，在下周召开的会议上，日本央行可能会微调对债券收益率的控制，但外界普遍预计，负利率政策直到明年才会结束。（观察者网））;1;7;8;10006;0.0007995202878273036
针对网上流传电商的兴起导致实体店铺倒闭，让实体经济陨落这一观点，小杨哥在直播间回应称，实体不会陨落的，并表示二者是相辅相成的。疯狂小杨哥回应电商挤压实体经济满谈企业然而，电商挤压实体经济发展，却是不争的现实，疫情后的大环境不好，更让这种对比变得强烈，大众消费在降级，电商满足展开;30;468;498;10006;0.04977013791724965
被共享单车整理员的薪资震惊到知乎大神超长贴：为什么全世界都在加息，而中国却在减息？疫情期间主要经济体降息保增长，现在疫情后大家加息控通胀。我们反向操作，且自以为有这样的实力。到底有没有，行不行？;-2;5;3;10006;0.00029982010793523883
美媒：韩国经济沦为美联储加息的牺牲品“美联储加息举措挤压美国关键盟友”，包括韩联社在内的多家韩媒日注意到，美国《华尔街日报》当天以此为题报道称，在拜登担任美国总统期间，韩美同盟有所加强的同时，韩国经济也沦为美联储高利率政策的“牺牲品”。报道认为，这导致如今韩国经济摇摇欲坠，韩国央行却难施援手。《华尔街日报》称，自年初以来，美联储开始了历史性的加息狂潮，试图平抑去年年中达到峰值的通胀。出于保护本国货币等原因，全球多国央行也纷纷跟进。韩联社提到，在不到一年半的时间里，韩国银行（央行）已加息次，到月已将利率推高至，此后一直维持在该水平。“这表明美联储的决定以及围绕这些决定的不确定性会如何在全球范围内激起涟漪。”《华尔街日报》写道。韩国电视台指出，韩国自身也面临着控制国内物价上涨率、房地产市场降温等问题，本国经济目前呈现出越来越不稳定的态势，美国利率的不确定性也为韩国央行带来了困扰。《华尔街日报》分析称，尽管大多数经济学家认为，美联储的加息周期已经接近尾声，但降息究竟需要多久才能开始，以及降息幅度会有多大，都还要打上一个大问号。汇丰银行（）首席亚洲经济学家弗雷德里克诺伊曼说：“美联储已经束缚了韩国央行。此处风险在于，如果美联储在很长一段时间内都无法降息，那么韩国经济可能会在利率过高的情况下走弱，这可能会成为经济增长的额外阻力。”韩联社称，事实上，韩国的“后疫情”消费热潮已经陷入停滞，房价长期低迷，经济增长也逐渐放缓。据国际货币基金组织（）预测，韩国今年的经济增长率仅为。自今年年初韩国央行最终停止加息以来，韩元对美元的汇率已贬值约；而美联储同期已四度上调利率，使得韩美利率差距拉大约个百分点。韩联社此前指出，原则上讲，作为非关键货币的韩元利率若显著低于美元，追求收益的外资将进一步外流，加剧贬值风险。“关于货币贬值，韩国政府有着一段痛苦的记忆。”《华尔街日报》指出，在上世纪年代末的亚洲金融危机期间，大量国际资本外逃导致韩元对美元汇率腰斩。这场危机导致韩国民众被呼吁贡献出私人黄金首饰，帮助国家偿还对的债务。撰写该报道的韩裔记者说，“这样的场景在韩国人的记忆中根深蒂固”。韩国经济当前的另一个主要问题是企业和家庭债务负担的不断加重。据日本野村证券估算，今年第二季度韩国企业和家庭债务占国内生产总值（）的比例上升到近，达到近年来的最高水平。尤其是家庭负债水平，韩国位居全球最高，其与之比为，如果算上“全税”（或称“全租、典税”）房押金，这个比例还将上升到。野村证券称，韩国负债家庭大约将收入的用于偿还债务，国内利息支出接近数十年来的最高水平。此外，本月爆发的以色列与巴勒斯坦伊斯兰抵抗运动（哈马斯）冲突导致的油价上涨，给韩国央行的决策增添了另一个复杂因素。在经历了几个月的宽松货币政策之后，韩国统计厅月日公布的数据显示，韩国月消费者物价指数上涨率为，远高于央行设定的的通胀目标，创下了自今年月以来的最大涨幅。上周四（日），韩国央行召开金融货币委员会会议，决定维持基准利率不变。这是继今年月、月、月、月和月之后，央行连续第六次在议息会议上决定冻息。分析认为，该决定的最主要因素仍然是经济复苏趋势尚不明朗。韩联社日报道指出，韩国今年第二季度实际环比增幅（）虽大于第一季度，但居民消费、进出口、投资、政府消费等均萎缩。由于进口减幅大于出口，贸易收支出现顺差。月的产业活动动向统计显示，零售销售指数连续两个月环比下滑，耐用品和半耐用品消费萎靡不振。报道认为，央行若只着眼于低迷的经济急于降息，家庭负债、汇率、物价等则令人担忧。经营研究院研究员曹永武（音）此前也曾表示，在主要国家经济增速放缓可能性加大的情况下，央行难以加息致经济进一步萎缩。在巴以冲突爆发的影响下，物价上升压力恐加剧，但也难以实施降息政策。这种“两难”局面有可能持续至明年上半年。《韩民族日报》说，美国长期利率上调的余波正通过多种渠道对全球金融市场造成冲击。联合国贸易和发展会议（）早前发布的《贸易与发展报告》认为，旨在对抗通胀的紧缩货币政策可能在全球范围内造成比年金融危机和年新冠肺炎疫情更严重的损害。报告发现，美联储加息每增加一个百分点，三年内其他富裕国家的经济产出将下降，而发展中国家的经济产出将下降。仅年美国加息就可能通过推高美元价值，让发展中国家减少亿美元的未来收入。;23;90;113;10006;0.011293224065560664
中金公司表示，的美债利率可能成为常态。该机构认为，基于当前的经济基本面，的利率属于合理定价。历史表明，金融周期上行阶段，信用扩张冲动更强，再加上疫情后供给冲击频发，通胀风险上升，所需要的货币紧缩力度更大，市场利率上行压力也更大。投资超话财经超话;2;2;4;10006;0.0003997601439136518
这里是底部区域应该达到了共识，但是不是最低点的底没人知道，也不会有人知道。所以，我们要做的就是“抓大放小”不要在意最低点在哪里出现，因为你根本无法判断，只要知道是底部区域，拿住手里低估的优质筹码就行了。快速的杀跌是见底前的标志之一，不要被这种走势吓到了，因为历史上每一次赶底之前都会如此相信后面会有更强的政策来改变当前的局势，毕竟经济的复苏是离不开股市的大涨年年亚洲金融危机后，年的行情；年金融危机后年行情；年股灾后年行情；年疫情爆发后年行情，这一次？年？;4;53;57;10006;0.005696582050769538
英媒：与哈马斯的战争打击了以色列经济英媒称与哈马斯的战争打击了以色列经济“与哈马斯的战争打击了以色列经济。”英国《金融时报》月日以此为题发文称，巴以本轮冲突已经导致以色列国内酒吧、餐馆、工厂等行业关门，货币汇率暴跌。经济学家预测，如果冲突长期持续，以色列经济将急剧收缩，政府赤字将大幅增加。报道称，在过去数十年的冲突之中，约旦河西岸和加沙地带的巴勒斯坦人饱受贫困和失业的困扰，以色列的经济则稳步增长。但哈马斯在本月早些时候对以色列控制区发起“最致命袭击”以来，以色列的经济运行迅速陷入了混乱。哈马斯的袭击直接对以色列的服务业造成了打击，以色列各地的餐馆和酒吧纷纷关门，上百个航班遭到取消。为了应对哈马斯的军事行动，以色列开展了创纪录的预备役动员工作，约万人被征召，这又导致仍在经营的企业出现人员短缺。冲突和紧张局势已经对以色列市场造成显著影响。报道称，以色列基准股指下跌，以色列谢克尔兑美元的汇率跌至，为年以来最低水平。投资者担心，旷日持久的冲突可能造成巨大的经济损失。以色列伊迈克和弗尔区（）的餐饮业老板杰里米威尔菲尔德（）告诉《金融时报》，在冲突爆发后的两周内，他的啤酒厂已经停产，他名下家餐馆中有家关门歇业，另外两家餐馆在午餐时间仅接待了名顾客。“正常情况下，一家餐馆一天能有到名顾客。现在我无法负担日常开支。我不知道这种情况会持续多久，这可能是压垮公司的最后一根稻草。”威尔菲尔德说。由于以色列正与加沙地带的哈马斯交战，同时又在北部黎以边境与黎巴嫩真主党发生交火，以色列南部和北部边境多个城镇的居民已经被疏散。例如在靠近加沙地带的南部边境城镇斯德洛特（），万居民中的被疏散，成排的商店关门。来自以色列北部的出租车司机尼娜米兹拉希（）表示，她在平日里一天完成到单生意，但在过去一周里，她平均每天只能完成单的行程。“没有工作可做，我不知道小生意该如何维持下去。”冲突对以色列旅游业的打击则尤为沉重。月至月是以色列传统的旅游旺季，但以色列导游协会主席加尼特佩莱格（）表示，出于对地区冲突的担忧，包括未来两年内的许多旅游行程都已被取消。“我们每天都会收到取消订单的通知。”佩莱格说，旅游行业的崩溃让人想起了新冠疫情期间的困难形势，“我们才刚刚从疫情中恢复过来，现在又遇到了困难。”《金融时报》称，枪支行业是少有的在冲突中出现显著增长的行业。自月日冲突爆发以来，以色列各地的枪支销量激增，以色列政府仅一周内收到超过万枪支许可证申请。以色列三家枪支商店的老板均透露，此次枪支销量的增长是“前所未有的”，许多商店不得不延长营业时间。以色列国家安全部长、极右翼政客伊塔马本格维尔声称，以政府将向约旦河西岸的以色列人免费提供万把武器，并将放宽枪支许可证的要求。经济学家预测，如果巴以本轮冲突长期持续，将对以色列经济造成沉重打击。以色列投资公司的首席经济学家盖伊贝特奥尔（）表示，本轮冲突对以色列经济的影响可能超过年黎巴嫩战争，该国第三和第四季度之间的经济产出可能收缩或。以色列财政部长比撒列斯莫特里赫已在日公布一项援助计划，旨在帮助受影响的以色列企业支付固定成本，并为无法上班的工人提供经济援助。以色列央行也采取措施，出售亿美元外汇以支撑本币汇率。但斯莫特里赫承认，援助计划可能导致以色列政府今年的财政赤字率扩大到，远高于此前设定的目标。经济学家对《金融时报》表示，预计明年以色列政府的财政赤字还将进一步扩大。巴以本轮冲突仍在持续，以色列国防军已对加沙地带进行了两周以上的轰炸，还多次威胁要对加沙地带发起地面进攻。以色列国防部长加兰特日表示，对加沙的地面进攻可能需要个月时间，他声称将“摧毁哈马斯”。但截至当前，以色列尚未下达地面进攻的命令。战火已导致冲突双方超过人死亡。以色列卫生部门表示，以色列方面有超过人在冲突中死亡。巴勒斯坦卫生部日发布消息称，加沙地带有名巴勒斯坦人死亡，约旦河西岸人死亡。;14;240;254;10006;0.02538476913851689
英媒：与哈马斯的战争打击了以色列经济英媒称与哈马斯的战争打击了以色列经济“与哈马斯的战争打击了以色列经济。”英国《金融时报》月日以此为题发文称，巴以本轮冲突已经导致以色列国内酒吧、餐馆、工厂等行业关门，货币汇率暴跌。经济学家预测，如果冲突长期持续，以色列经济将急剧收展开;50;240;290;10006;0.028982610433739755
沪市今天又跌了。除了机制性的内在原因，很多分析人士认为，美国国债收益率飙升和美元高利率造成巨大外部压力，结论是：这个压力不变，中国股就难有起色。大概是内在原因解决起来更加复杂，美债收益率的影响更容易看清，人们发现了美债收益率以及北向资金动向与中国股市的强联系，并且形成了视之为“风向标”的集体心理暗示。然而说到底，这些都是技术原因。股市是市场信心的“晴雨表”，而市场信心又是社会信心的“风向标”，这样的根本属性决不能忘记。现在的根本问题还是信心弱，股市的信心低迷同时反应了整个社会当下信心的不足。如果说我们的信心需要美债收益率的变化来启动、扭转，那未免荒唐了。必须看到，中国社会增加综合信心有着很多动力来源，如果我们不向内开掘它们，那将是我们的集体不作为。目前的宏观大形势，中国是不错的，现在世界上有两场战争，中国都没有卷入，我们的位置在战略上相对有利。在国内，我们走出了三年的严重疫情，经济恢复是大势所趋。虽然美国有些闹“脱钩”，但它在相当大的程度上“脱”不动，美国近一个时期在稳定中美关系，尤其是稳定双方经济关系方面挺主动的。中国在芯片领域的突破和电动车的高速发展对整个西方都是冲击，房地产泡沫的消化带来了经济动力的短时减弱，但这肯定不是对中国经济的根本削弱。中国人口下降是个问题，但是它是个慢性问题，也不该形成冲击的爆发，而且中国接下来有很多机会比其他面临同样问题的国家更好地扭转这个问题。我说人口下降的影响不该过大，是因为与中国广大人民群众对过更美好生活强烈愿望所对应的发展潜力比起来，显然后者在今后所能提供的动力要远大于人口在同期下降所造成的衰减。我真是认为，我们的社会有着充分资源和能力将包括市场信心在内的综合信心全面振作起来。而要做到这一点，必须针对人们最关心、国家也相对最容易发力的领域真正行动起来，创造耳目一新的感受，给全社会提供新的信心支撑。我认为，这个领域就是实现速度更快、能被全社会感知、让大多数人产生更多获得感的经济增长。必须指出，虽然有不同历史阶段的原因，但是推动经济增长是中国整个国家和社会在过去几十年里最擅长做的事情。今天中国的人均尚与发达国家有很大差距，在我们国内，地区发展也很不平衡，这些都为经济的继续增长和高质量发展预留了巨大空间。让我们不仅把这个目标坚决树立起来，而且要切实转化为行动，应当让高质量的经济增长成为各地政府的首要考核目标，具体怎么做到，各地主要官员应当自己联系当地实际殚精竭虑，创造出各种办法，国家大目标的鞭子要坚决抽出各地的干劲和智慧来。各地要发展经济，就不能搞虚的假的，不能搞形式主义，不能禁锢思考和创新，就得要以效果为导向，因为各地经济好不好，最终的评价权都是属于人民群众的。现在各地都在喊发展经济，但还是在一些领域放不开手脚，怕“政治不正确”的帽子，网上出现一些说三道四的帖子，都会产生惊吓，这明显是闯劲和担当不够嘛。要把社会的活力和创造性充分释放出来，不能不说，大多数地方现在做的都还不够，对社会信心和市场信心提供新因素支撑的贡献太少了。不能够放任股市持续跌下去，在经济很旺的时候，那样的问题或许不大；但在经济相对低迷的时候，它可能意味着更多风险和不确定性。而要走出整体的低迷，技术性的调整当然需要，但是只做头疼医头脚疼医脚的临时补救远远不够，我们采取措施的总目标应当是对市场的信心进行“抄底”，把扭转股市与提升全社会信心当成同一项大工程开展行动。;2;114;116;10006;0.011593044173495902
股现在的股灾已经明确了原因，和后疫情，战争，房地产，外资，国内经济没啥关系，就是注册制注册制就是木桶的那块短板，不把这块短板补齐，再多的水也装不满这桶;2;0;2;10006;0.0001998800719568259
中金：的美债利率合理吗？美债风暴席卷全球中金发布研究报告称，美国经济数据好于预期，美债年期收益率冲破，该行认为基于当前的经济基本面，的利率属于合理定价。历史表明，金融周期上行阶段，信用扩张冲动更强，再加上疫情后供给冲击频发，通胀风险上升，所需要的货币紧缩力度更大，市场利率上行压力也更大。不排除一种可能，的美债利率是未来的新常态，这种状态并非脱离基本面的存在，而是金融周期波动，叠加供给侧结构性变化带来的结果，也是全球政治、经济、社会发展到这个阶段的一种规律。中金：的美债利率合理吗？下载搞定全球市场网页链接;3;1;4;10006;0.0003997601439136518
中金：的美债利率合理吗？美债风暴席卷全球中金发布研究报告称，美国经济数据好于预期，美债年期收益率冲破，该行认为基于当前的经济基本面，的利率属于合理定价。历史表明，金融周期上行阶段，信用扩张冲动更强，再加上疫情后供给冲击频发，通胀风险上升，所需要的货币紧缩力度更大，展开;3;1;4;10006;0.0003997601439136518
香港经济最新数据，真的差截至月底，港府于本财政年度首五个月录亿元赤字，财政储备跌至亿元，相当于约年政府开支受市况拖累，地价及印花税两大主要收入上年度均已大缩水，市场预料本年度亦难达标，其中地价收入过去两季估计只有约亿元，仅为全年预算的另外，疫情后公共开支却未明显下调，本年度开支预算超过亿元，令社会忧虑港府未来可能会削减公共开支香港香港财政预算案;9;13;22;10006;0.002198680791525085
香港经济最新数据，真的差截至月底，港府于本财政年度首五个月录亿元赤字，财政储备跌至亿元，相当于约年政府开支受市况拖累，地价及印花税两大主要收入上年度均已大缩水，市场预料本年度亦难达标，其中地价收入过去两季估计只有约亿元，仅为全年预算的另外，疫情后公共展开;6;13;19;10006;0.001898860683589846
美股和股最近一段时间都是下跌为主，反而市有点回升，大概率是因为关于大茅台通不通过的问题。回过头看，这轮熊市也经历了不少，俄乌战争，巴以战争，老美加息，疫情后经济衰退等等。如果之前这些都结束，会不会来一轮牛市呢。;9;50;59;10006;0.0058964621227263645
未来何在？中国过去四十年的经济高增长如今要变成中低速时代。后疫情时代，中国经济也无法回到高增长时代。我们该如何配置资产？一个奇特的现象，股延续大跌破点，房价下跌各种巨头欠债倒下，存款利率下降，央行降息化债推动理财、基金与保险整体收益率下降，同时人民币还在持续贬值，中国家庭如何投资，如何避险？在下一个阶段的大类资产配置中，我们需要规避以下六大风险：宏观：随着制度改革预期改变，叠加国际政治风险增加，非经济因素以及行业监管的不确定性对宏观、行业、市场、企业、资产价格以及家庭财富带来的影响增加，家庭需要关注房地产税、遗产税、个税稽查等政策，以及罚款等非税收收入的上涨。减值：告别高增长时代，意味着财富大爆炸时代结束，“买到就赚”的时代结束，二三四线城市房价持续下跌，一线城市房价除了核心区外难以维持，房地产“负资产”数量将增加，全国城市家庭资产因房价下跌而全面缩水，多数中产及以上家庭房产“黄粱一梦”，无法锁定房产价值。债务：债务将是牵引未来经济走向的主要问题，地方债务、开发商债务都可能影响经济走势，对家庭构成外溢性债务风险，如无法收回工程款、烂尾楼无法交付、失业引发房贷断供、三角债纠纷等，而通缩带来的实际偿债负担增加将给家庭带来广泛压力。利率：利率持续下降将削减中国家庭最大规模的金融资产存款的收益率，将引发资产配置难题与焦虑。汇率：人民币长期贬值趋势将全面削弱以人民币计价的所有资产，包括房产、土地、股票、商品、工资等。代际：中国老龄化进程将比日本更快，加上养老金不足、地方政府债务规模庞大，未来养老负担沉重，普通家庭需要高度关注养老保障以及下一代的教育保障。;1;282;283;10006;0.028283030181890864
中国过去四十年的经济高增长如今要变成中低速时代。后疫情时代，中国经济也无法回到高增长时代。我们该如何配置资产？一个奇特的现象，股延续大跌破点，房价下跌各种巨头欠债倒下，存款利率下降，央行降息化债推动理财、基金与保险整体收益率下降，同时人民币还在持续贬值，中国家庭如何投资，如何避险？在下一个阶段的大类资产配置中，我们需要规避以下六大风险：宏观：随着制度改革预期改变，叠加国际政治风险增加，非经济因素以及行业监管的不确定性对宏观、行业、市场、企业、资产价格以及家庭财富带来的影响增加，家庭需要关注房地产税、遗产税、个税稽查等政策，以及罚款等非税收收入的上涨。减值：告别高增长时代，意味着财富大爆炸时代结束，“买到就赚”的时代结束，二三四线城市房价持续下跌，一线城市房价除了核心区外难以维持，房地产“负资产”数量将增加，全国城市家庭资产因房价下跌而全面缩水，多数中产及以上家庭房产“黄粱一梦”，无法锁定房产价值。债务：债务将是牵引未来经济走向的主要问题，地方债务、开发商债务都可能影响经济走势，对家庭构成外溢性债务风险，如无法收回工程款、烂尾楼无法交付、失业引发房贷断供、三角债纠纷等，而通缩带来的实际偿债负担增加将给家庭带来广泛压力。利率：利率持续下降将削减中国家庭最大规模的金融资产存款的收益率，将引发资产配置难题与焦虑。汇率：人民币长期贬值趋势将全面削弱以人民币计价的所有资产，包括房产、土地、股票、商品、工资等。代际：中国老龄化进程将比日本更快，加上养老金不足、地方政府债务规模庞大，未来养老负担沉重，普通家庭需要高度关注养老保障以及下一代的教育保障。;22;481;503;10006;0.050269838097141716
中金：的美债利率属于合理定价中金公司研报指出，美国经济数据好于预期，美债年期收益率冲破，中金认为基于当前的经济基本面，的利率属于合理定价。历史表明，金融周期上行阶段，信用扩张冲动更强，再加上疫情后供给冲击频发，通胀风险上升，所需要的货币紧缩力度更大，市场利率上行压力也更大。不排除一种可能，的美债利率是未来的新常态，这种状态并非脱离基本面的存在，而是金融周期波动，叠加供给侧结构性变化带来的结果，也是全球政治、经济、社会发展到这个阶段的一种规律。;8;22;30;10006;0.0029982010793523886
美国债最后是谁们买单呢？年期美债收益率超过中金：的美债利率属于合理定价财联社月日电，中金公司研报指出，美国经济数据好于预期，美债年期收益率冲破，我们认为基于当前的经济基本面，的利率属于合理定价。历史表明，金融周期上行阶段，信用扩张冲动更强，再加上疫情后供给冲击频发，通胀风险上升，所需要的货币紧缩力度更大，市场利率上行压力也更大。不排除一种可能，的美债利率是未来的新常态，这种状态并非脱离基本面的存在，而是金融周期波动，叠加供给侧结构性变化带来的结果，也是全球政治、经济、社会发展到这个阶段的一种规律。年期美债收益率超过;0;6;6;10006;0.0005996402158704777
老金：再难也要搞高科技早上写了一篇微文，谈疫情后美国经济复苏快于我们，两国差距从缩小变为拉大，特别提到了美国重塑高端制造业，大力发展人工智能与数字化，对高科技和高端制造加大政府补贴等做法。发这个微文的目的是希望我们知己知彼，保持理性，沉着应对。估计有的人看了心里不舒服，以为是展开;2;7;9;10006;0.0008994603238057165
在经济优势加持下，娱乐业会加层光环，比如九十年代的港台；叠加了意识形态，娱乐业会是降维打击，如五六十年代的英国，八十年代后至疫情前的美国；拭目以待叠加了五千年文明的娱乐圈会出来什么样的影响力。;16;157;173;10006;0.017289626224265442
这不是一个好的趋势，有了消费经济才能起来，内需才能被扩大这代年轻人能有多会省钱越来越多的年轻人开始追求一种简朴、低成本的生活方式花得少了，攒得多了。后疫情时代经济和就业的压力，以及人们对于物质生活的观念的转变;12;29;41;10006;0.0040975414751149315
这代年轻人能有多会省钱据中国日报双语新闻报道：越来越多的年轻人开始追求一种简朴、低成本的生活方式花得少了，攒得多了。后疫情时代经济和就业的压力，以及人们对于物质生活的观念的转变，让年轻人开始拒绝奢侈和浪费，对消费主义说“不”。比起无意义的虚荣和面子，他们更注重实用性。展开;-22;9;-13;10006;-0.0012992204677193685
呆呆的摸鱼基地超话这代年轻人能有多会省钱据中国日报双语新闻报道：越来越多的年轻人开始追求一种简朴、低成本的生活方式花得少了，攒得多了。后疫情时代经济和就业的压力，以及人们对于物质生活的观念的转变，让年轻人开始拒绝奢侈和浪费，对消费主义说“不”。比起无意义的虚荣和面子，他们更注重实用性。比起盲目地“买买买”，他们更追求性价比，相信简朴的生活也能带来快乐。;5;5;10;10006;0.0009994003597841295
这代年轻人能有多会省钱据中国日报双语新闻报道：越来越多的年轻人开始追求一种简朴、低成本的生活方式花得少了，攒得多了。后疫情时代经济和就业的压力，以及人们对于物质生活的观念的转变，让年轻人开始拒绝奢侈和浪费，对消费主义说“不”。比起无意义的虚荣和面子，他们更注重实用性。比起盲目地“买买买”，他们更追求性价比，相信简朴的生活也能带来快乐。;322;463;785;10006;0.07845292824305417
本博对此的态度是所谓规规矩矩拿签证工作上学移民的都是本省有钱人，本省特别是本市多得是愿意在这种事情上打通门路一掷千金的人，但是走线的人确实就是更多的，那几个地级市早几十年就是一村一村的迁出去，包括疫情放开后很多人挽救家庭经济的思维不是像很多地方一样做技术力低展开;0;10;10;10006;0.0009994003597841295
年将是一轮中等级别的牛市，推动市场向上的动力来源于疫情、政策和经济的不确定性逐渐消失所带动的风险评价下行与风险偏好回升。全年的投资机会可以概括为“跟消费谈恋爱，跟科技结婚”，前半阶段的机会主要在以消费为代表的价值类股票，后半阶段行情重点则是科技板块。;1;0;1;10006;9.994003597841295e-05
预测年结婚人数万新生人口万年结婚人口万新生人口万年疫情管控，有些结婚延后，年小幅跳涨，但年估计还会延续跌势，新生人口因经济不景气仍难扭转下滑势头。年之前，经济蒸蒸日上，人们尚无工作不好找收入下滑的概念，中介算月供时总会说五六年后这点月供算啥。但这两年过下来，人们开始明白原来有可能失业、收入下降、断供，于是无论买房、结婚还是生娃都会趋向理性。平板手机普及之后大家沉迷短视频游戏，经济低迷企业不会足额招聘员工，三个人干四个人的活，无形中工作时长会增加，这些都会影响拍拖找对象。;1;6;7;10006;0.0006995802518488907
江西政府或有债务超千亿，再获百亿级特殊债支持江西有的地区债务风险等级上升，存在一定偿债压力，此次获得中央化债支持。月日，根据江西财政厅发布的公告，当地成功发行了亿元特殊再融资债券（下称特殊债），用于偿还存量债务。这一规模目前在已经披露发债计划的个省份中，相对靠后，跟上一轮江西发行特殊债规模相近。这一轮特殊债额度主要向债务负担较重的地方倾斜，以置换部分当地政府负有偿还责任的隐性债务，来延长期限，降低利息，缓释风险。这也是中央一揽子化债方案的重要举措。江西此次获得部分特殊债额度，也引起市场对其财政债务形势关注。江西近些年经济增速有所放缓，但经济总量稳步增长，去年首次突破万亿元（约万亿），在全国个省份中排第位。经济决定财政，江西财政收入规模也在全国居中游水平。近些年受疫情冲击，经济增长放缓，叠加大规模减税降费、房地产市场低迷等影响，当地财政收入增长也有所放缓，不过近些年依然保持增长，略好于全国平均水平。;5;8;13;10006;0.0012992204677193685
论人口重要否在这个经济高速发展的时代国家领导把人口问题又提上日常但随着一线二线城市到三线四线五线六线城市再到农村的房价增长，医疗增长，教育增长已经让很多老百姓难堪重负疫情前老百姓都是盲目跟风，房价一直涨所以很多刚需掏家底也要来一套一场疫情让很多人看透了，人活着并不一定要每天为了钱四处奔波那些年已经为了钱失去了自我，疫情后人们都看开了所以房地产持续走向低迷但是还是让很多人望而却步房地产成了人口最强硬的拦路砍因为中国人最注重的一件事就是要有房可住，女方要男方有房子才会嫁在这个高房价的社会有多少人能一步买好房子，，分期买了后，紧衣缩食还敢多生孩子吗？生一个有个后代就可以了所以说总之一句话，房子不掉价人口永远上不去，而且房子医疗教育国家再不大力管制打压人口断崖式下跌不是没可能，保人口还是保经济？？？？？？？？？？？;2;3;5;10006;0.0004997001798920647
前三季度国民经济恢复向好去年经济受疫情防控冲击很大，对今年经济同比数据造成低基数效应。因此，正确读解今年经济数据必须扣除基数效应。扣除后今年一，二，三季度的增速分别为，和。两大要点第一，经济在三季度从二季度的底点有所恢复。第二，但经济仍然仍然处于弱复苏，三季度经济增长比二季度高，但仍然低于一季度。第三，扣除低基数效应后，三季度增速仍然稍低于年疫情期间的平均增速。远低于疫情前的正常增长率。因此，亟需加大扩内需提信心的政策力度促进经济尽快回归正常运行轨道;6;22;28;10006;0.0027983210073955628
美元的问题确实很大，虽然短期还是稳固的，但潜在问题不容忽视。看美联储资产负债表，每一次危机至少扩表倍，经济正常时期的几年再扩表一倍。年只有不到万亿美元，现在万亿美元，疫情后直接翻倍。如果说后面美国再来一次危机，直接干到万亿美元，真的很难想象是什么情况，美元会泛滥到何种地步。美国和欧洲的通胀本质上是有区别的。美国的通胀跟能源危机关系不大，虽然经济复苏是基本面方面的因素，但流动性泛滥也是不容忽视的，在流动性泛滥的情况下单纯的加息对抑制通胀效果可能不一定是好的。一个典型的例子是土耳其，土耳其货币泛滥就比较严重，他的利率水平现在也很高，但仍面临高通胀的困扰。美元地位的丧失可能就是以高通胀为标志，什么时候美国控不住通胀了，什么时候美元也就完了。;7;42;49;10006;0.004897061762942235
前三季度同比增长，其中第三季度虽然同比增长了，这个数据对国人来说不起眼，但它超出了外界预期，特别是环比增长了，说明很多措施起作用了，这是好兆头。今年经济总体看没有形成人们期待的疫后强劲反弹，尤其是第二季度比较弱，市场有所失望。但另一方面，经济的确在恢复，旅游、展开;1439;8567;10006;10006;1.0
基金超话财经苏州走访了几天，大家普遍反应今年是比较困难，困难程度有甚至超过年。年危机出现后，四万亿刺激，立马把经济拉了回来，当然后续也留下了很多后遗症。目前经过几年的疫情，这几年里的体验其实是比年更差。就像熊市一样，一个是短时间快速下跌，之后快速拉回另一个是缓慢下跌，跌幅不算太大，但大家心理体验极差。汇率在顶部从月份又横盘了两个月了，还是那句话，汇率这里横盘后是要往下大跌的。但在眼下横盘的时候，非常难熬。熬过去才有戏，熬不过去的比比皆是。再坚持坚持吧老铁们。;38;136;174;10006;0.017389566260243853
股大概率有超越年一遇级别的牛市疫情中，我也是这么想疫情后经济的;1;4;5;10006;0.0004997001798920647
中国消费金融公司洞察报告（）消费金融超话年是经济社会进入“后疫情”新阶段的第一年，随着全面恢复常态化运行，国家部委出台一系列针对性政策措施，引导金融机构按市场化方式，加大对多个场景的综合金融支持力度，进一步为消费金融公司指明了发展方向。在居民消费需求不断释放，展开;1;0;1;10006;9.994003597841295e-05
手账版一带一路知识点逆势而上，“一带一路”未来前景广阔面对空前的困难和挑战，世界各国更需携手合作、聚焦发展、寻求共赢。而中国的“一带一路”倡议可有效拉动增长，促进投资，创造就业，发掘潜力，从而振兴经济，实现可持续发展。当前更加凸显了共建“一带一路”的价值，验证了共建“一带一路”的韧劲，为高质量共建“一带一路”走深走实开辟了更广阔的前景。一带一路，国家级顶层合作倡议。“一带一路”（，缩写）是“丝绸之路经济带”和“世纪海上丝绸之路”的简称。依靠中国与有关国家既有的双多边机制，借助既有的、行之有效的区域合作平台，一带一路旨在借用古代丝绸之路的历史符号，高举和平发展的旗帜，积极发展与合作伙伴的经济合作关系，共同打造政治互信、经济融合、文化包容的利益共同体、命运共同体和责任共同体。年，中国与共建国家进出口总额累计达到万亿美元，年均增长；与共建国家双向投资累计超过亿美元，其中中国对外直接投资超过亿美元。截至年月底，中国已与个国家、个国际组织签署多份共建“一带一路”合作文件。鸿儒计划透过财经看世界;4;16;20;10006;0.001998800719568259
喜马拉雅第讲：股政策底是最大误区，从未出现过，唯有经济底网页链接。很多股民，总喜欢说政策底，但从股市角度，至少股历史上方面，从未有过任何一个单纯的政策底，至少老股民从没有在股经历过，这了有的只有经济底。今儿我们也来详细聊聊市场走势规律，诸多政策密集周期的展开;1;2;3;10006;0.00029982010793523883
俺们后都在牲畜一样的读研考公请问世界善待后了吗老天爷你对零零后还想多差大学大学封校疫情三年毕业毕业疫情经济颓软没工作岗位考研考公人多的卷的跟花菜一样老天爷你把我们这一批后当过孙子吗我请问到底是谁在替我岁月静好攻击后祸乱职场的是在我倒是想祸乱一下呢给我个职位倒是;2;1;3;10006;0.00029982010793523883
去超市买的蒜苗块大约根，超市大约个鸡蛋块多，吊饼块，加上佐料油烟电费共计块多。如果去路边小餐馆这样的要收二十多，去掉人工店面还是利润可观的。后疫情时代，消费下行，但餐饮行业还是可以的，毕竟人还是要吃饭的，吃饭就要酒，酒是大头。这也是为数不多现在我能看到点希望的行业。换个角度想一想，非餐饮行业的人呢？本就经济低迷，结果吃饭的成本还没有下降。我也没见过多少蛀虫般的带货主播把米面油的价格“打下来”，他们最喜欢卖名酒，朱门酒肉臭。多喝点，醉醺醺的也不用看着烦恼。人身上的腐肉，表面敷点膏药是没有用的，挖出来才行啊，云端之人赵贞吉：“苦一苦百姓，罪名我来担。”;1;0;1;10006;9.994003597841295e-05
两个最重要的因素原创亨特发表于四川图片国庆后的第一周市场走势依然相对弱势，哪怕是上半周走势较强的港股也在周五出现了暴跌，一周涨幅几乎被一天抹平上周有两组非常重要的经济数据发布，这两组经济数据影响着当前市场的最重要的两个变量，美国的通胀和国内的经济。月美国通胀数据略超华尔街预期，同比增长，高于市场预期的，环比增，高于预期。其中美联储最关注的核心同比增持平于预期，低于前值的，为连续第个月回落，核心季调环比增，持平于预期和前值的。超预期的主要原因是汽油，油价的大幅上涨导致美国的数据出现反弹。从这个角度来说，目前的中东局势对于美国通胀来讲非常重要，如果中东局势进一步恶化，蔓延到伊朗，沙特等重要产油国，那么油价必然会进一步暴涨，导致美国通胀高企，我们期待的美联储宽松也不会到来，形势将无限接近于上个世纪七十年代的超级大通胀。从这个角度来看，中东的局势目前是影响全球资本市场很重要的一个因子，这周末博弈很明显在加剧，伊朗外长开始放狠话，各地的游行示威规模越来越大。博弈加剧可能意味着事态发展到了极致即将缓解，也有可能意味着事态要失控，这个变量毫无疑问是短期全球资本市场最大的变量。美国的核心目前相对稳定，下行趋势是很明显的，这其中核心商品的持续下滑，核心服务依然在高位震荡，下滑不明显。核心服务中最顽固的是房价相关的数据，住房（业主等价租金（和房价趋势趋同）房租外宿），另外出行相关的机票，娱乐行业也比较顽固。房价相关的数据在核心中权重非常高，一旦这个权重得到缓解，美国的核心将快速下滑。而从一些高频数据来看，美国的房价在超高利率影响下（目前房贷利率个点）已经明显出现了下滑，这意味着往后看一段时间，美国核心出现缓解是大概率事件。总的来说，如果中东的形势可控，那么美国的加息很可能已经到了非常末期，而如果中东的形势不可控，事情就会滑向不可预知的方向。国内经济数据上周也有一些国内经济数据发布。关注度最高的是社融，月的社融数据简单来说就是中规中矩。月新增社融万亿元，同比多增亿元，高于市场预期（一致预期万亿）；实体信贷增加万亿元，同比少增亿元，略低于市场预期。比较积极的一些变化是：居民部门信贷明显改善，居民中长贷增加了亿元，存量房贷利率的调整以及地产政策调整推动了房贷的增长；企业部门中长贷增加了万亿元，看起来同比还是下滑的，但这是因为去年疫情下企业贷款冲量很厉害基数太高，这个数据已经是近五年同期次高水平。还有一个比较细节的地方，未贴现银行承兑汇票增加亿元，同比多增亿元，这应该意味着企业的经营活动在变多，所以才会大规模的开承兑汇票。比较差的地方是：同比增长，较上月下降；同比，进一步低于前值的。，更多是衡量经济的活跃度，这两个指标依然比较差，特别是在上个月较差的背景继续变差，其中主要拖累项是企业的活期存款，这意味着经济的活跃度还是比较差。另外月住户存款增加万亿，老百姓继续存钱不花钱，对于未来的预期依旧悲观。总的来看，我们的社融信贷数据在政策的大力推动下还是不错的，但经济的活跃度依旧不太高，市场依然缺乏信心。除了社融数据，上周还有国内的进出口数据和数据发布。进出口数据方面。月国内出口当月同比（美元计价）回升至，明显好于市场预期，一致性预期是，出口环比增长，环比改善非常明显。其中对发达经济体出口增速大幅回升至，这是出口回暖最主要的原因。从行业来看，消费电子（手机电脑），汽车的出口回暖是最明显的。进口方面，月进口（美元计价）同比回升至，考虑季节性因素和国际大宗商品比如油价价格上涨这个回升幅度很小，显示出国内的需求依然比较差。整体来说国内的出口形势是在逐步好转的。月国内数据均低于市场预期，月环比上涨（同比增长），月环比（同比下滑）。这里有一个很现实的数据，国内水产品价格持续走低，再结合近期大闸蟹价格暴跌的新闻，目前国内的水产需求非常差。这一方面受到日本排核废水影响，不少人都因此放弃吃海鲜，另一方面也和经济整体下行，居民支出意愿下滑有关系。水产价格下行叠加猪肉价格维持低位，再加上房租等服务类消费也不太景气，导致国内比较差。总的来说就是国内的需求依然不太强，这和前面进口数据反映的事实是相似的国内的经济数据基本都指向相似的状况，国内内需依然维持在相对比较低的水平但也没有进一步下滑，出口在逐步改善，政策也在持续发力。总的来说就是经济在底部有企稳，并没有进一步下滑，明显有改善，但力度依然比较弱。国内经济这条线呈现出弱复苏的状况。从这条线来看，至少股市不应该具备进一步下跌的基础和空间了，但上涨的空间可能需要更明确的改善信号来打开。从宏观来看目前来看影响股市的两个最重要因子，海外的通胀和国内的经济。前者关键看中东形势，如果不恶化可能最差的时候已经过去了；国内经济最差的时候应该已经过去了，不会对市场再造成太大拖累了，之后期待的是更多积极因素推动下的数据进一步改善，这可能会成为市场上行的重要契机。阅读万亨特写下你的留言精选留言消费股连续跌了三年了，消费降级，未来人口下降，消费股还有投资机会么作者消费难度很大了，关键是核心标的估值也不低啊，跌三年了也跌的不够多的房贷那房价应该维持不了多久。作者肯定啊，这么高房贷谁去贷款买房啊不过确实美国需求旺盛，这种房贷价格下还出现了业主惜售（卖了就买不到低利率的房子了），供给也减少了，所以房价没有崩。奋斗消费电子出口增长，不会是苹果新机的贡献吧破涕为笑作者同比不用考虑这些变量，去年同期也有苹果新机。;1;0;1;10006;9.994003597841295e-05
经济下行已是定局？今年月去了趟义乌，档口忙忙碌碌的是前来拿货的生意人。大家都想疫情后大干一场，拿货比以往多倍。档口老板看此情景，又加大了几批生产。几个月过去，仓库堆满了库存做生意看大环境。静下心，不要把假象当真像。经销商想好好干一场，可消费者不买单，最后都是库存。展开;6;20;26;10006;0.002598440935438737
去年中国结婚人数跌破万对这个话题真的不够客观，年开始，连续三年疫情，这是一个很重要的时代背景因素，是直接影响婚育率的。如果讨论结婚人数，就不能脱离经济环境的影响，否则这种讨论没太大意义。我查到的一些数据，发现越是经济上行时候，婚育率数据越高企，国内几次大规模经济增长点中展开;11;164;175;10006;0.017489506296222267
先评后转：楼市九月未镀上金，十月未镶上银，倒是暴雷房企愈来愈多，在拼命的四季，楼市如果依然没有燃情。人们担心的很多事却会一二三齐齐惊现。实际上楼市逆转，经济修复，疫情后的产业振兴比很多人乐观的预期要差。三年所积之重，难返当在意料之中，此时此刻，知前路危艰，鼓足拼博勇气，千方百计，用心甩脑用力克艰攻难才是上上策。而粉饰太平，沉浸虚无缥缈的梦幻西游之中，则会误楼市误房企误经济。警世、醒世、禅悟不是惧怕，而是回到现实当中来。转：年起，若是房地产市场无法逆转，全国或将出现大转变今日头条网页链接;5;8;13;10006;0.0012992204677193685
：柬埔寨今年经济增长料达领头亚细安国际货币基金组织最新报告显示，柬埔寨将成为亚细安中经济增长最快的国家。分析员指出，出口导向型制造业如服装业的复苏，是后疫情时代柬埔寨经济增长的关键动力。：柬埔寨今年经济增长料达领头亚细安;1;28;29;10006;0.0028982610433739755
泰安齐鲁晚报发现泰安泰安日报泰安首条醉泰安泰安县令泰安新鲜事也打了不知道多少个了，天天被摆摊的小贩堵成这样，老城区就活该这样嘛？疫情之前早市到点就结束了，自从疫情开放后，商贩都这么肆无忌惮了小商贩能带动经济嘛？挤兑的缴税的小超市都干不下去了;2;0;2;10006;0.0001998800719568259
中国消费暂时未恢复到疫前水平中国取消新冠疫情“零容忍”政策后，经济、生产活力和服务业开始逐渐恢复。鉴于第三国经济问题不可避免地限制了对中国的出口需求，大家对消费作为中国经济增长的主要动力还是寄予厚望；与此同时，中国消费尚未恢复到年疫情前水平；国际货币基金组织对中国与斯里兰卡达成债务重组感到惊讶；欧盟计划对中国钢铁厂实施反补贴调查；华为期望明年智能手机销售增加一倍。中国消费暂时未恢复到疫前水平;15;15;30;10006;0.0029982010793523886
疫情后的经济形势还不如疫情期间呢咋这么差;1;1;2;10006;0.0001998800719568259
从这一角度来理解打卡，很可。不过，后看到的打卡，好像已经成了后生活中必不可少，甚至最重要的一部分了，这个似乎令人担忧了。难道，这是时下疤痕经济下的年轻人的真实的业态和生活态度吗？疫情让人改变，比如变得更现实，对将来的期待大打折扣，更享受当下的生活。只是，如果年轻人把打卡，把看电影，把看展，把穷游看成是生活的全部或重点，这，会是一个问题。;1;0;1;10006;9.994003597841295e-05
红杉重磅报告：最严峻时刻已到来作为谷歌、苹果背后的风投公司，红杉资本凭借在经济危机期间与其投资组合公司分享的演示文稿和备忘录，赢得了科技行业“卡珊德拉”（，希腊神话中的特洛伊公主，能够预知未来）的美誉。在题为“适应与忍耐（）”的页幻灯片中，红杉将当前动荡的金融市场、通货膨胀和地缘政治冲突一并列为不确定性和变化的关键因素。红杉告诉创始人们，不要指望经济会像大流行开始后那样迅速反弹，因为“推动经济复苏的货币和财政工具已经被耗尽”。同时，红杉也建议创始人迅速采取行动以延长跑道并全面检查业务是否存在超额成本。“不要将削减估值视为负面因素，这是一种节省现金和快速发展的方式，它能帮你跑得更远。”这次不是“型复苏”虽然美国经济在年月受疫情影响出现下滑，但在之后迅速反弹，经济学家称之为型复苏，红杉认为这种情况将不会再发生。报告中指出，货币和财政政策已经用尽，持续的通胀和地缘政治冲突进一步限制了宏观层面解决问题的能力。为了应对疫情，世界各国政府采取财政和货币刺激措施，以填补疫情造成的巨大缺口。这有助于防止了极其严重的衰退，但也带来了严重后果。这种“放水”体现在了资产价格，尤其是在那些符合疫情主题的远程办公和电商公司的股票上。市场低迷将对消费者行为、劳动力市场、供应链等产生影响。这次危机将是一个更长的周期，虽然不能预测持续时间，但仍需做好准备。美联储的两个核心工作就是最大化就业率及控制物价稳定，但目前看来他们并没有做好。不仅红杉预感到了危机，知名风投也在一篇博文中提到，“过去十年的繁荣时代毫无疑问已经结束”。谁能存活下来？那在这种情况下，谁能存活下来呢？答案是适者生存：最终并不是最强大的物种存活，也不是最聪明的，而是最擅长对变化做出应对的会存活下来。就像和两家公司，最快做出应对的公司拥有更多的现金流，更可能避免死亡螺旋。所以我们建议你计算好各种节约成本的方式，比如关停一些项目、停止研发、减少市场开支、或其他，这并不是说你要马上行动，但你要知道如果未来天内就要用到，你是准备好的。我们看到，年的时候，所有缩减开支的公司最终都活得更好。不要把缩减开支当做一个负面的事情，而是把它当做节省现金和跑的更快的方式。此外，要思考你计划做出的决策，和你希望你当初做出的决策的关系。当你只剩六个月的现金流的时候，专注和决策会变得非常困难，所以不管你还剩多少钱，从现在就开始思考。该如何准备？红杉认为，帮助创业公司度过寒冬的主要方式包括：重整团队：重申公司的使命愿景、价值观，留住有价值的员工重视现金流：时刻关注油箱增加盈利：拓宽盈利渠道、改善经济模型、裁员，融资或融债：哪怕成本很高聚焦投资主要业务：远离无纪律和原则的市场追求，比如砍掉了绝大部分产品，但却在关键的托管业务和长期住宿业务上增加投入。思维创新：把精力放在用更好的解决方案来解决问题上，而不是把钱投到问题上，面对问题改变是唯一选择。;1;1;2;10006;0.0001998800719568259
《衣食住行》（）穿衣戴帽各有所爱原来认为三楼是美食广场其实不然二楼和三楼都是以百货精品屋为主其中参杂着其它的类型的服务项目如美容、理发、美甲其实无论经济上行，还是下行，或者是平行在综合性商场里都能有所反映尤其是商品的销售量绝对是一个硬指标然而影响消售量的主要因素是客流量因此，商业的景气度的确是由客流量和销售量决定的玉兔捣药由此可以判断目前经济所处在哪一个阶段便是一目了然也许有人会说，正负一层楼的吃货研究所不是人气爆棚吗？其实这正是所要回答的关键所在只能说明后疫情时期的经济形势和经济状况尚在复苏的阶段大多数消费者仍然处在温饱状态二、三楼百货商场里的景气度的回升，才是经济上行的主要标志（文，图自拍。）;24;43;67;10006;0.006695982410553668
既然我是财经博主了，我就分享一下中金报告的数据吧。国资财富占比左右，但是只解决了一成的就业。剩下的民营企业占比多，但是解决了九成就业。储蓄仍然很高，但是消费和作为最大宗消费的房地产流动性却大幅降低。而最近的经济就业率问题，放水好像效果不大。。。很可能在于空转。直白的说，就是印了不少钱，但是没有去到能创造财富，解决就业的企业手里。总结：民营企业需要支持才能解决今天的就业和经济问题。疫情后，全社会对个人财富安全性的认知很可能有变化，需要重新强调。银行是废物不能指望了。;63;390;453;10006;0.04527283629822107
罗云熙超话蚌埠官方夸长月烬明功德无量罗云熙长月烬明真的太棒了，带动非旅游城市蚌埠疫情后的经济复苏，带来增长，真的是功德无量;1;0;1;10006;9.994003597841295e-05
著名心理学家弗洛伊德认为，一场创伤结束后，它的直接影响会被个体遗忘，但创伤所带来的心理后遗症仍将持续。经历过大灾大难后，人们的行为会不自觉地发生变化。比如，有研究发现，在印度尼西亚，那些经历过地震或海啸的人，在之后的年中性格会明显变得更加保守，做出冒险行为的可能性会比其他人群的低，在日本，大地震后的年时间内，震区居民会变得更加厌恶风险。人们会因为一次重大事件永久性地改变自己的行为模式。即使之后一切回归正常，经历过重大危机的消费者也未必愿意大胆花钱，企业未必愿意正常投资、生产，暂时关门的小微个体未必能够重新开张。美国哥伦比亚大学金融学教授劳拉维尔德坎普用“疤痕效应”来描述这种现象。疤痕效应，简单说就是人们在过去遭受了创伤，经过了一段时间的恢复，伤口虽然已经愈合了，但疤痕依然存在。疤痕会时刻提醒着人们过去的伤痛，全部康复后，伤痛依然会有持续的影响。俗话说，一朝被蛇咬十年怕井绳，这就是典型的疤痕效应。疤痕效应，不止发生在身体之上，同样也适用于经济生活的领域。人们在经历了一次重大事件后，会永久性的影响和改变自己的行为模式。在普林斯顿大学布伦纳梅尔教授的《韧性社会》中，他总结了疫情为社会经济带来的三重疤痕，对未来经济造成深远的影响第一，打击乐观精神和风险承担意愿，在民众的内心中留下疤痕。第二，人力资本因为失业期延长而受损，给劳动力市场留下疤痕。第三，债务积压，特别是破产程序如果久拖不决，会给企业留下疤痕。所有这些疤痕，都会影响社会的经济活动，以压低长期的增长和发展速度。疫情年后，即便是一切回归正常，但人们期待的烟火气，可能不会马上的恢复如初。譬如，人们未必愿意去大胆的消费，企业的投资也未必积极和乐观，关闭的小店，未必会马上重新开张，失业的人群，也未必会能快速的走出来。我们在头脑中的疤痕，会让我们对未来的预期不会过度的乐观，烟火气的恢复会更加的缓慢一点，因为人类会对巨大的伤痛存有长久的记忆。;9;104;113;10006;0.011293224065560664
中国过去水大鱼大的经济，得益于两个引擎，一个是外贸，一个是城镇化。外贸主要是以中国的低成本（人力、环境、土地）来承接外需（美国和欧洲）。而城镇化，主要是承接外需过程中工业化引发的基础设施建设（道路、桥梁、机场）以及商品房需求。从某种意义上，中国过去三十年经济的组织模式主要是围展开;4;20;24;10006;0.0023985608634819106
罗云熙超话罗云熙罗云熙长月烬明汉服回潮年看西安罗云熙气汉服大片传承中华文化罗云熙汉服回潮年文化推广大使神魔博弈，烬旻为子，神魔合体，以志胜天长月烬明的精神内核其实非常高级，所以赢得了广大观众的认可，助力“非旅游城市”疫情后经济复苏，被官方认可，实至名归罗云熙;35;17;52;10006;0.005196881870877474
国际锐评丨超级“黄金周”让那些唱衰中国的杂音黯淡收场国内旅游出游人数亿人次，按可比口径同比增长，较年增长；国内旅游收入亿元，按可比口径同比增长，较年增长；电影票房收入突破亿元；全国铁路发送旅客超过亿人次刚刚结束的中秋和国庆长假，中国消费市场呈现出一派繁荣火热的景象。德国《法兰克福汇报》网站称，旅游热潮被视为中国经济复苏的标志。对中国民众而言，国庆节是一年中最重要的节日之一。人们习惯利用这个难得的长假外出旅游购物，因而国庆节又被形象地称为“黄金周”。今年的国庆节，是中国疫情防控平稳转段后迎来的首个国庆假期。国内外市场机构此前普遍预测，随着中国经济恢复步伐加快，国内消费市场将迎来久违的火热场面。过去八天，从繁忙拥挤的火车站，到人流如织的著名景区，再到一票难求的演出市场，都验证了这一判断。有媒体指出，今年的国庆是“五年来最火爆的黄金周”。中国商务部日发布消息称，今年国庆假期，中国消费市场人气旺、活力足，销售平稳较快增长，绿色、健康、智能类商品销售明显增长。有分析称，中国消费市场之所以在这个假期迸发出巨大活力，一方面在于人们被疫情压制的出行购物需求得到充分释放，另一方面在于中国各级政府推出一系列政策措施，积极恢复和扩大消费，拉动了社会消费需求。今年国庆“黄金周”展现的繁荣景象，是中国经济企稳回升的重要信号。当前，世界经济复苏乏力，外部环境更加复杂严峻，而中国经济在持续恢复中展现出韧性与活力。今年上半年，中国国内生产总值同比增长，在全球主要经济体中保持领先。今年前个月，中国主要经济指标回升向好，全国规模以上工业增加值同比增长，社会消费品零售总额同比增长，固定资产投资同比增长，服务零售额同比增长。特别是今年月份以来，在一系列扩大内需、提振信心、防范风险政策举措的推动下，中国工业和服务业生产加快，国内需求继续扩大，国民经济恢复向好。以中国官方日前发布的月份制造业采购经理指数（）为例，已经连续个月回升，并且自今年月以来首次回升到扩张区间。美国《华尔街日报》网站日前报道称，在欧美加息使消费者和企业陷入拮据的情况下，中国经济显示出活跃迹象，为全球经济带来希望。国际货币基金组织发言人日前表示，已从最近的数据中看到中国经济企稳的迹象。花旗集团、高盛等国际机构纷纷上调对中国全年经济增长的预测。这些都表明，国际社会对中国经济复苏的信心不断增强。联合国贸易和发展事务负责人近日指出，外界夸大了对中国经济问题的担忧。客观地看，中国经济面临的国际环境依然复杂严峻，国内经济结构性矛盾和周期性因素叠加，持续恢复基础仍然有待巩固。但另一方面，国庆假期的火热消费场面清晰表明，中国经济韧性强、潜力大、活力足，长期向好的基本面不会改变。可以预期，随着稳增长政策效应的不断释放，中国经济运行中的积极因素有望不断增多。在世界经济增长动能不足的大环境下，中国经济将以强劲韧性继续带动全球经济复苏。这也会让那些唱衰中国经济的杂音再次黯淡收场。（国际锐评评论员）;2;2;4;10006;0.0003997601439136518
昨天跟春狗吃饭，我问他：你说三年前，我真的要跟你开一家店，我们会不会开成呢？他说会当然三年后如果想开那家店，其实也还是能开，然后我就说，可能我们就会倒在疫情里面，然后让你血亏几十万了，哈哈哈哈哈，然后我们就关系决裂，或者现在很努力的打工还债了。很多时候说不上来，不知不觉间就三年了，总感觉大家的变化，都好像没有什么，可能是经济形式不好，我没什么东西去怨的，如果我真的三年前不读这个研究生，我又去做什么呢？我现在又会是一个怎样的人呢？不知道，但现在我也不再好奇，如果走上另外一条路的我是怎样的。我好像只期待现在我，想要去做的事情。;1;1;2;10006;0.0001998800719568259
贝弗里奇曲线以英国的经济学家威廉贝弗里奇命名的用来表明职位空缺与失业人数在怎样在经济周期中变化的曲线可以用来帮助区别摩擦性失业结构性失业和周期性失业。最近这根曲线争论不休，参考下文：软着陆硬着陆，何谓“贝弗里奇曲线”之争？网页链接疫情后贝弗里奇曲线出现外移，近月数据均处于曲线的上半段陡峭部分。上文可以看出海外经济学家之争水平确实非常高，高度的学术化讨论同时又跟实践高度结合。里面的前财长萨默斯和布兰查德都是高手，可以长期关注;1;79;80;10006;0.007995202878273036
现在美国要全力控制的是经济过热而不是经济萧条，华尔街没想到疫情期间美国决定投入万亿美元用于全美国的基础设施维护和改造，以刺激经济和增加就业，华尔街预测受疫情重创的美国经济至少需三年恢复，没想到各项指标远好于预期，预计明年可恢复到疫情前状态。律说美国房地产律说美国经济在纽约的微博视频;175;2022;2197;10006;0.21956825904457325
价值投资日志超话今年以来股一波三折，行业轮动速度明显加快回顾今年以来股的走势，整体可以分为三个阶段，年初国内疫情快速达峰后经济快速修复，在此支撑下，月股延续自去年月底以来的底部第一波上涨行情，上证指数和沪深分别上涨和；行业层面呈现普涨的格展开;1;1;2;10006;0.0001998800719568259
中美之间消费能力差在哪里？按道理来说，中国人的存款比例远比美国人高。为什么中国的消费不如美国呢？其实本质的问题，在中产。对比海外的中产，这几年和咱们差距是越拉越大。中产是消费的主力。疫情后，中产的工资没有怎么涨，其实美国的中产工资上涨幅度也不大。美国还有严重通胀。但消费能力，就业情况，经济情况差这么多。没有道理啊。但仔细看数据，大多则是购买美股指数这类资产稍多点，而年国庆以来这四年，标普涨了，纳斯达克涨了。美国崩溃后迅速上涨超过了。而股这几年还在点，股票与基金无不亏钱。同样是有万买指数基金，美股现在是万。股投资人现大是万，或者是万。这差距就有万以上了再说房产，过去四年一线城市挂牌价指数也仅仅上涨了左右，然后今年基本又回到原点了。有的中产房子已经跌到年左右了。也就是说资产价格倒退了年。而美国大城市房价指数涨幅达。人民币贬值，理财大跌，各种烂尾楼，，信托大雷持续不断。一个资产在增值，一个资产在爆雷。中美两国的消费能力差在哪里了。经济情况差在哪里了，还不是很清楚吗？如果我们的股票也涨了，房子也涨了，经济情况将会完全不同所以，股票与房子不崩盘，甚至走出一些稳定的行情。是大势所趋。让中产恢复，能花，敢花钱的能力，经济就起来了。。。;0;359;359;10006;0.03587847291625025
越南经济缺乏强劲势头。月日，越南公布的年月实际国内生产总值增长率同比为。虽然越南经济正在从新冠疫情中缓慢复苏，但主力的制造业表现不佳，出口持续负增长。要想实现全年增长的目标，目前形势严峻。“年内不太可能出现复苏”，一位钢铁行业人士如此表示。越南的钢材需求约用于建筑，但关键的建筑需求仍在减少。台湾的鞋业公司“宝元越南”进入年后进行了次裁员。分析认为共有多人被解雇。缝制工厂的经营者表示，“到年底，停业的服装企业将增加”。生产一线发出了这种缺乏经济复苏实感的声音。占近成的矿工业和建筑业等制造业仍处于低迷状态。出口也不景气，月的出口额同比下降约。月仍为负增长，出口额较大的个人电脑和服装的真正复苏依然遥远。;4;38;42;10006;0.004197481511093344
中美之间消费能力差在哪里？按道理来说，中国人的存款比例远比美国人高。为什么中国的消费不如美国呢？其实本质的问题，在中产。对比海外的中产，这几年和咱们差距是越拉越大。中产是消费的主力。疫情后，中产的工资没有怎么涨，其实美国的中产工资上涨幅度也不大。美国还有严重通胀。但消费能力，就业情况，经济情况差这么多。没有道理啊。但仔细看数据，大多则是购买美股指数这类资产稍多点，而年国庆以来这四年，标普涨了，纳斯达克涨了。美国崩溃后迅速上涨超过了。而股这几年还在点，股票与基金无不亏钱。同样是有万买指数基金，美股现在是万。股投资人现大是万，或者是万。这差距就有万以上了再说房产，过去四年一线城市挂牌价指数也仅仅上涨了左右，然后今年基本又回到原点了。有的中产房子已经跌到年左右了。也就是说资产价格倒退了年。而美国大城市房价指数涨幅达。人民币贬值，理财大跌，各种烂尾楼，，信托大雷持续不断。一个资产在增值，一个资产在爆雷。中美两国的消费能力差在哪里了。经济情况差在哪里了，还不是很清楚吗？如果我们的股票也涨了，房子也涨了，经济情况将会完全不同所以，股票与房子不崩盘，甚至走出一些稳定的行情。是大势所趋。让中产恢复，能花，敢花钱的能力，经济就起来了。。。（关邱小姐索，少走弯路）;2;117;119;10006;0.011892864281431142
经典留言：怎么我刚参加工作，经济高速增长就一去不复返了。是我拖累了经济增长吗？人各有命，《红楼梦》里，贾母几乎一辈子大富大贵，宝玉、黛玉十几岁就赶上了贾家由盛到衰个人看法，是比较幸运的一代人，刚参加工作，社会比较宽松，全程享受中国经济发展最快的时代后包括后毕业赶上疫情和经济压力来临之时，需要接受一定考验，可能需要付出更多才行;9;23;32;10006;0.0031980811513092145
美媒：美国或在年出现大萧条以来最严重崩盘据美国福克斯新闻网日报道，越来越多的数据表明，一场破坏性超过大萧条的经济崩盘可能即将在年降临美国。白宫和国会如果不尽快削减政府支出，结果可能是灾难性的。报道称，目前美国经济已是如履薄冰，很快就会陷入另一场大规模危机之中。最新数据显示，过去三个季度全年货币供应量增速为负，这意味着可用货币量正在快速萎缩。在过去的年里，美国唯一一次货币供应量急剧下降是在世纪年代初大萧条最严重时期。然而，当前尽管全美货币供应量崩溃，但物价仍在上涨。全美家庭处境严峻，越来越多的人正在耗尽积蓄并负债累累以支付基本生活开支。正是美政府激进经济政策导致这场危机。美国政府在年疫情最严重时大举借债印钞。同时，美联储实施前所未有地货币投放政策。尽管经济学家发出警告，但美联储仍要求国会支出更多并将利率保持在极低水平。新一届政府上台后继续将支出拔高到超过疫情前的水平，最终导致通胀飙升至四十年高位。为抑制通胀，美联储已激进加息次，导致大多数商品及服务价格远高于疫情前水平，给美国家庭带来了前所未有的压力。;2;41;43;10006;0.004297421547071757
美国或在年出现大萧条以来最严重崩盘海外网月日电据美国福克斯新闻网日报道，越来越多的数据表明，一场破坏性超过大萧条的经济崩盘可能即将在年降临美国。白宫和国会如果不尽快削减政府支出，结果可能是灾难性的。最新数据显示，过去三个季度全年货币供应量增速为负，这意味着可用展开;16;359;375;10006;0.037477513491904854
焦点坊谈超话超话美媒：美国或在年出现大萧条以来最严重崩盘据美国福克斯新闻网日报道，越来越多的数据表明，一场破坏性超过大萧条的经济崩盘可能即将在年降临美国。白宫和国会如果不尽快削减政府支出，结果可能是灾难性的。报道称，目前美国经济已是如履薄冰，很快就会陷入另一场大规模展开;5;26;31;10006;0.0030981411153308013
境象超话半夏李美女最新宏观分析，惹不少争议这很正常因为宏观太复杂，角度维度尺度随便找个都能挑出遗漏，所以批判它很容易；（另一个原因人红关注多）比如她说：（美国）即便明年预算赤字维持目前计划的高位，因为利息支出占比大幅提升，甚至占据大部分的的赤字空间，美展开;1;3;4;10006;0.0003997601439136518
回顾今年的市场，真是感慨万千，从春节后的疫情放开满怀憧憬，到经济的不及预期，股指回落，人们经历了从喜到悲的又一轮循环。经济是这样反映到股市的，当股指的技术应该朝上的时候，如果经济繁荣，它会火上浇油。如果经济萧条，一个个不好的消息，会被人们看成利空出尽，股指仍会不断新高。如果技术是朝下的，一切利好都是做空的理由，利空更是做空的理由。（转）;2;24;26;10006;0.002598440935438737
回复王有财现实是在疫情关键时刻清零才稳住了大局，在国际一片混乱中保持高效生产力和出口增长，研发追赶，保住了经济成果，这才有了开放后的一切。你永远可以说吃第六个馒头之前的五个都是骗你钱的。秀智商是你的自由。;2;703;705;10006;0.07045772536478113
其实对中国经济的分析，也与原帖中的描述有关：悲观者认为中国无法走出疫情的疤痕效应，且会螺旋式下降；而乐观者则认为疫后的内生修复与政策扶持会带来新的动力，只是累积效果尚不足够明显。;8;71;79;10006;0.007895262842294623
疫情后的经济现状实体店说今年营业额比去年疫情期间还差身边企业负责人都说客户口袋里都没钱我想说我们企业也很难大家要撑住;1;3;4;10006;0.0003997601439136518
易纲：当前经济运行中的几个特点当前我国经济总体仍处于疫情冲击后的恢复阶段，要有信心和耐心。随着经济主体资产负债表不断修复，居民会逐渐增加消费支出，进而创造收入和更多消费。国际上看，消费从疫情中基本恢复需要年左右时间，而我国目前才半年，恢复仍需要一个过程。但也要看到，二季度以展开;1;1;2;10006;0.0001998800719568259
王者荣耀还需要设计年的台历嘛？疫情后的经济不太好了吧;13;112;125;10006;0.01249250449730162
花西子打工人专属货币单位在大家玩梗中，看到了经济下行的心酸，花西子多少钱根本不重要，工资言论才是真正让消费者寒心的原因，疫情后的经济，人口老龄化，大学生就业问题，人口出生率，每一个都是压垮普通人的最后一根稻草;2;21;23;10006;0.002298620827503498
李佳琦就直播言论致歉想起前几天我们几个后跟老板吃饭，老板开始摆谱装腔，想“教育教育”年轻人，问我为什么年轻人流行躺平。我说因为羹被分完了，阶级固化，信息被封锁，有钱人掌握大部分风口，我们因为信息差不知道太多赚钱渠道，实现阶级跨越很难。加上疫情影响，经济下行，就业也很难。我们展开;2;14;16;10006;0.0015990405756546072
这届年轻人为何变得抠门了毕竟疫情后的经济环境东西都贵了要是不省着点一个月生活费都不够花的;1;0;1;10006;9.994003597841295e-05
收入低的人更容易感到孤独据盐财经：在《孤独社会》一书中，三浦展指出，在日本少子高龄化趋势严重的当下，还在上学的未成年人同时要照料家人，成年后还可能面临着失业、疾病、经济等问题，就算是恋爱、婚姻也变得无法缓解孤独，孤独的年轻人正在变多。三菱综合研究所生活者市场预测系统（展开;2;15;17;10006;0.0016989806116330202
全球最大的两个经济体美国和中国，年的经济，都处于魔幻之中。先来说美国。根据官方公布的数据，美国经济，那可谓是连续超出市场预期，真实增长动不动就上修。四月份的时候，美国公布的年一季度真实环比年化增长率是，但，就在月日，这一数据被上修为，几乎提高了一倍。美国二季度增长率也同样超过了最初的市场预期，环比年化增长率为，同比增长率为，虽然后来修正为，但要知道，去年年底的时候，大家都还预计美国年二季度增长要下降到附近呢美国物价，也一直在增长，无论是通胀率还是核心通胀率，都明显高于美联储所设定的的目标，在这种情况下，美国的真实仍然实现明显增长，可见经济是真的好。对于美国经济增长的强劲和韧性，美国的失业率数据和人员工资数据也能佐证。过去半年，美国的失业率一直维持在历史最低位附近，保持在以下，而职位空缺数据则一直保持着历史最高位，这意味着美国有大量的工作在找人，而不是人去找工作。另外，美国的人员工资也持续上涨，只要是私营部门，无论是体力劳动者的，还是非体力劳动者的，都是在一路增加，以至于还让美联储主席鲍威尔不断强调，说这个原因可能造成通胀非常“有韧性”。对于经济好不好，反应最灵敏、最聪明的，当然还是资本市场。哪怕美联储将美国基准利率提高到了年来的最高水平，美股却在年月份触底之后持续反弹上涨，虽然最近一个多月经历了一些波折，但整体上远远高于去年的低点按照技术分析的说法，美股，已经妥妥地进入牛市。好了，既然美国经济很好，那么美国政府的财政收入肯定也会很好啊错美国联邦政府这半年的收入，其差无比从年月到年月，美国财政收入连续个月同比负增长，这意味着政府收入相比去年大幅度下降。财政收入大幅度下降，但美国老爷们的财政支出，那可是一点儿都不能减少的，甚至还要再增加，于是乎，美国的财政赤字一路攀升，过去个月的累计赤字高达万亿美元，仅次于疫情期间，妥妥的全球第一借贷大户，搞得好像美国又发生了疫情一样数据来源：不仅如此，最神秘的是，美国经济这么强劲增长，但无论工业生产用电还是居民住宅用电，或是商业用电，美国的用电量相比年都有明显下降。要知道，在今天的工业文明时代，绝大多数经济活动都要依赖于电力这种能源，经济在强劲增长，用电量却持续下降，这不仅仅是“用爱发电”，而是用爱发展经济啊数据来源：关于美国经济，以上一系列逻辑上有些互相矛盾的数据，你说它到底是好，还是不好？如果美国数据没有造假，以上逻辑都能够成立的话，我掐指一算，只能解释说：）美国政府宁肯借钱，也要少收企业和民众一点儿税，促进美国经济增长和资本市场繁荣；）美国人失业率很低，全民有工作，收入还逐渐增加，那说明民众被资本家隐性剥削而意识不到；）美国人过去半年，在节约能源的情况下实现了经济增长，要么是提高了能源使用效率，要么是美国的经济活动增加，靠的是基础服务业兴旺发达，不依赖能源。接下来说说中国经济。不管什么时候，中国的经济在官方措辞里，一定是“稳中向好”，区别只是在于，稳有多稳，好有多好。根据统计局数据，过去个季度，中国的增长很稳，也很好，远远超过美国。年一季度，中国同比去年实际增长率高达，是美国的倍以上；年二季度，中国同比去年实际增长率高达，是美国的倍。也正是因为经济好，政府收入也蹭蹭蹭地提高，美帝政府总是给老百姓福利，收买选票，却不顾自身债务缠身，相比之下，我们中国政府就是负责任政府，洁身自好，不需要收买民众，所以过去几十年财政收入都一直蹭蹭地上涨，每年涨幅都远远超过增速，年上半年财政收入数据增长率高达，也远远超过经济增长速度。中国的经济增长稳中向好还有一个证据，那就是我们的发电量数据。过去十几年，伴随着中国经济的高速增长，作为全球最大的生产国，中国的发电量，一直在稳步增加，除了年由于动辄封控、出口停滞等原因，发电量出现过阶段性下滑，其他时间中国的发电量基本上跟随经济增长。年上半年，中国发电量数据仍然是在持续增加的，这也能够佐证，中国作为全球最大的生产国，地位并没有变，中国也的确是有真实的经济增长的。数据来源：接下来该说魔幻的部分了。美帝靠爱发电，经济增长数据貌似喜人，我们中国经济增长是美国的三倍，发电量也增加，按道理来说，作为经济体微观细胞的企业，也应该大赚而特赚才对。可是，同样来自统计局的数据，规模以上工业企业，利润相比去年同期下降。经济增长“稳中向好”，增长率是美国的三倍，但企业赚钱，却大幅度下跌，只有政府收入蹭蹭蹭地涨，你说这是不是有点儿魔幻？失业率数据，也能与工业企业利润下降对应。按道理来说，中国这么好的经济状况，经济增长比美国快三倍，失业率应该持续下降才对。但实际上，中国的青年失业率在一路走高，特别是，国家统计局把每周工作个小时以上的人全部都算作就业的情况下，中国的青年失业率依然达到了。当然，因为世界政治经济形势错综复杂，经济社会在不断发展变化，统计工作需要不断完善，劳动力调查统计也需要进一步健全优化，所以，国家统计局决定，自今年月份开始，全国青年人等分年龄段的城镇调查失业率将暂停发布按照很多自媒体的公正说法，这个数据明明是可以造假的，但我们的统计局反而诚恳承认“需要进一步健全优化”，所以选择不公布数据。这种诚实客观，相比美帝那些看起来公开透明但每次都要进行季节性调整的数据来说，不知道高尚和先进多少倍更魔幻的是，虽然青年的失业率大幅度上升，以至于取消数据发布，但我们老百姓的可支配收入，却依然是增长了虽然跟不上增速，更跟不上政府收入增速，但那也是妥妥的增长啊从逻辑上推断，这说明了什么情况？说明只是年轻人没工作，但中老年人失业率并不高，而且，在职人员收入都大幅度提高了关于通胀方面，根据各自的官方统计数据，美帝的通胀水平很高，而我们的通胀水平很低，所以，老百姓收入看似增加了一点点，但我们统计出来的数据显示，中国现阶段基本没有通胀，甚至快要通缩了，老百姓的实际财富，是大大地增加了的。但这就又有问题了。因为，按照世界主要国家的经济数据逻辑，不可能普通人收入快速增加，而物价却快要陷入通缩，但我后来想，在我们中国的数据逻辑中，老百姓收入虽然增加很快，但，因为要应对高房价、医疗、教育、养老等问题，可能不会转化为消费，所以就不会造成通胀。另外就是，我们中国的通胀统计数据构成中，猪肉占了相当大的比重，只要控制住猪肉价格，其他的涨一点儿没啥影响，通胀数据也会显得对老百姓极其友好。通胀的事儿咱暂且不说了，更可气的，是在资本市场。大股明明估值这么低，政府还细心呵护，央行还通过等，把市场利率都给降下来，但从春节后到现在，大股却整体上一路下跌，阴跌不止。钱是最聪明的，股市阴跌说明，这半年上市企业经营状况不怎么好，这似乎又能够与工业企业利润大幅度下滑对应起来。所以，魔幻又互相矛盾的一系列数据，你说说看，中国经济到底是好还是不好？最后，在中国实际经济增长率相当于美国倍的情况下，我们对比一下过去年中美两国的情况：年的时候，美国是万亿美元，中国是万亿美元，我们相当于美国的还要多（）；年的时候，美国是万亿美元，中国是万亿美元，我们相当于美国的；年上半年，按照个季度滚动总和统计，美国是万亿美元，中国是万亿元人民币，结合最新汇率计算，是万亿美元，我们的相当于美国不到（）。;7;43;50;10006;0.004997001798920648
李佳琦带货怼网友李佳琦的话真的太伤猪猪女孩的心了后疫情时代经济不断下行很多人都找不到工作的情况下李佳琦却说是打工人不努力，才涨不了工资要反思自己（反思怪上大分？）结构性不公一直存在社会资源也不是公平地分到每个人手里有人水淹地铁还要想办法上班否则就要扣工资而你在直播间展开;2;8;10;10006;0.0009994003597841295
财富读书会超话《认知经济周期的客观规律》小序第四周读完第四章作业：（必做）按照科学思维，你判断一下未来几年中国经济是否会进入衰退周期。（结论不重要，重在展示你分析的逻辑）（选做）这部分内容你有什么疑问吗？可以最多提一个问题给大麦，可能会被选中，在下周的直播课里被解答哦一、概论中国经济经过多年的高速发展，在未来多年可能进入缓慢增长或衰退经济周期，国内国际经济持续低迷下行。二、强国之路，工业化的发展道路根据全球发达国家的发展历程与经济发展过程来看，一个国家的经济发展是波动的、有周期的，不可能一直持续增长，一直高速发展的。欧美资本主义国家经过上百年的发展，各国也都先后完成了工业化、城镇化与现代化。从落后的、欠发达国家或地区进入到高度发达的资本主义国家。包括邻近我国的日本、韩国以及亚洲曾经高速发展的“四小龙”，同时也包括我国香港、台湾与澳门早期发的达地区，经济波动是属于常态，不可能一直持续高速发展。曾经的沧海变桑田，我国革命历史重现眼前：历经了鸦片战争时期的半殖民地半封建社会，劳苦大众煎熬了民国时期的连年军阀混战，经济发展满目疮痍。国家经济不但停止不前，而且还经历了战争的毁灭性的创伤与打击。历经近半多个世纪的战火纷飞，庆幸有共产党带领广大群众年抗战，成功击败日本侵略者；又在国内解放战争取得了历史性的转折与突破，直至取得了伟大的胜利，于年建立了新中国。国内生产力也获得大解放，经历了社会主义初级阶段的发展，把一清二白、贫穷落后的、工业基础薄弱的国内经济，进行了初步的建设与改造，奠定了我国工业发展的基础框架。在邓小平理论及邓小平总设计师的统帅下，激情昂扬走进了改革开放的新进程、新阶段。我国经济从年的改革初期，经过改革开放年的大发展，建立了现代化的新中国，也逐步完成了工业化、城镇化、现代化的经济大发展仅仅用年的发展就走完了欧美国家两百年的发展之路，创造了世界经济的奇迹。三、城镇化之路我国通过这年的高速发展，国家经济从年以来以及疫情年，面临着巨大压力与挑战。回顾自年打破国家分房政策以来，我国房地产的商业时代来临了，以“商品房”为代表的中国地产高速发展，一路高歌猛进，为中国经济注入极大的活力与发展原动力。然而年成为房地产的拐点，房地产及地产金融不断暴雷，兑付危机层出不穷。不论是恒大还佳兆业，二三线龙头房企碧桂园，以及销售回款以快著称的融创地产或万科地产老兵等其他地产商都进入了震荡与衰退期。我国经济的繁荣与高速增长，离不开中国地产的创新与发展。目前，我国的城镇化水平已经达到以上，有的城市如深圳、北京、上海等一线城市城镇化率到达以上，甚至超过了欧美发达国家。房地产也进入了发展的瓶颈期，地产经济时代已经结束。四、出海之路，国际化及出口贸易从国际贸易及国内出口带动经济发展，我国从年香港回归以及年加入后，经过工业化的高速发展逐步成为世界的加工中心，建立了全产业链的工业基础，国际贸易连续多年不断创新高。然而从年及年疫情以来，面对以美国为首西方国家对我国实行高科技封锁与围堵，中国与国际贸易脱钩，受到美国及西方国家的围攻与打压，整个国际贸易从全球化进入岛链化，国内国际经济环境发生了巨大的变化，全球经济进入逆周期，处于下行的低迷状态。五、商业之旅，商业模式升级迭代俗话说“无工不富，商不通，无农不稳”，工业化与城镇化相互促进发展，又带动商业化的发展。全球的工业化中心历经由美国到日本，再有日本到亚洲四小龙，以及随着改革开放再次转入我国大陆，中国的经工业逐步变强成，最后为全球的加工中心，成为“世界的加工厂”。全球化的工业中心所到之地，各国经济也都经历了的高速发展与成长、经济繁荣、股市上扬、经济一片大好随着中国工业化，城镇化的完成，以及外国资本主义的围攻堵截，国际的加工中心也外溢到越南等东南亚欠发达国家与地区。商业模式的创新与发展，从年改革开放以来南货北移，商业贸易开始走向繁荣也带动了经济的发展。商业创新与商业模式的迭代升级，从坐商到行商，由行商到电商，再由电商到微商，直到当下的由微商到播商，全国上下都在抢占播商商机。我国的商业贸易也从小打小闹走向跨国出海。然而，疫情过后目前经济疲软，发展内力不足，大家都觉的疫情年难熬，疫情结束了，经济应该有所好转。但事实上并非如此，从各种信息统计，大家都一致表示“疫情年很难，疫情结束了年比疫情更难”，消费并未复苏，经济还是步履维艰，大的经济环境还是低迷，仍然处于下行状态。带动国内经济的三驾马车“出口、投资与消费（内需拉动不足）”也是无力回天。六、人口红利消失随着中国经济的发展，人口红利期结束。高储蓄率、人口老龄化、少子化成为中国（犹如年前的日本）一个新表征。从年中国人口出现拐点，第一次出现负增长，年新出生人口不到万，仅有万，年后的高出生率的人口也到了退休年龄，中国每年将有万的退休潮不断涌现，我国也会快速进入老龄化经济状态，养老医疗成为国家最大的民生问题。经济衰退、人口下降、老龄化、少子化也会成为中国经济的明显特征。七、科学思维，总结陈词我们利用金字塔的科学思维，从城镇化、工业化、老龄化、商业模式创新及全球经济变化及各国现代化的发展历程，以及国际化贸易的现状及中国经济的未来是否有更大的动力，促进我国经济的发展多个维度论证了未来经济面临的压力。我国经济可能出现下行的大环境，国际国内经济在未来很长一段时间持续低迷下行。当然，科技的发展与创新也会带动经济的大发展，尤其是人工智能以及的出现，也许会为我国及全球经济注入新的活力与发展动力。我国在新经济、新技术的带动下进入下一个发展高峰。愿我们祖国更加繁荣昌盛，太平盛世年然而，历史的车轮不是以人的意志为转移的，全球的经济发展规律还是客观存在的，任何一国的经济发展与成长也逃脱不了客观规律之道。经济周期影响着全球经济的走向与变化。李峰，北京;7;54;61;10006;0.00609634219468319
这个问题我觉得是许多人文社科学者毕生追逐的命题，一切学科研究到了最后似乎都走向哲学。我最近最大的感受是这几年疫情、经济下行、网络狂欢下来现在互联网上铺天盖地的犬儒，一切价值都有被消解的可能，发疯文学、老奴文学还有各种形形色色的互联网热梗感觉都在用看似博人一笑的形式消解很多价值的底展开;23;556;579;10006;0.0578652808315011
李佳琦带货怼网友天呐，他知不知道自己在说什么，疫情年经济正在复苏，今年先是失业潮后又天灾不断，不管是郭家层面还是消费者层面，谁听得这种话啊一直很喜欢李佳琦，看了遍，不是粉丝说的断章取义，就是不耐烦且略带鄙视，干嘛啊，觉得自己在另一个纬度了，曾经的“所有女生”们的努力已经配不上了？;6;71;77;10006;0.007695382770337798
德国工业新订单出现疫情以来最大降幅反对派议员炮轰政府周四，在德国联邦议院进行预算辩论时，多名反对党的议员对现任政府在经济领域的糟糕表现提出了尖锐的批评。前卫生部长、现任基民盟议员施潘表示，目前“的民众不信任政府”，这种不信任将刺激民粹主义的发展。周三，德国总理朔尔茨呼展开;5;5;10;10006;0.0009994003597841295
美联储加息到多少会罢休？我认为会加到衰退为止，美联储一直隐晦不说的事实是他们加息缩表的目的就是为了拉爆美国经济。想要解决通胀有两个办法，提高供给或压低需求。疫情初期发钱太多，又有很多人不工作生产，正好都叠加了。财政部的以工代赈遥遥无期，只能靠掌管货币的美联储做空需求。做空需求展开;4;401;405;10006;0.040475714571257246
国内的经济环境已经差到难以想象。新闻硕士秋招颗粒无收，其他学校本硕更不谈。各大厂不断缩招，文科生近两年毕业即失业。街上的每个人都看起来好疲惫好不快乐，学生、家长、打工族。过去那套成功学价值观早已失效，努力换不来果实，所以直接躺平，然后把活一天算一天挂在嘴边。疫情三年后越来越多的人开始说及时享乐，因为努力没有了意义。不要评判现象，要去看现象背后的原因。;1;1;2;10006;0.0001998800719568259
美国基础设施建设的力度，是最近二十年最大的。这为疫情后的美国经济带来就业增长和通货膨胀。;1;5;6;10006;0.0005996402158704777
新闻热点案例分享经过三年疫情中“清零”反复折腾，再解除“清零”封控后的经济复苏并未奇迹出现。土地财政动力推动及多年的过度建设和过度借贷引发了房地产危机，住房与城乡建设部月底提出包括“认房不认贷”在内的购房优惠政策方向后，上周，住建部、央行、金监局等三部委又联合发文，推进“认房展开;1;0;1;10006;9.994003597841295e-05
调查温州老板没躺平前不久，温州发布的数据显示，温州上半年为亿元，按可比价计算，同比增长，高于全国的水平。其中，第二产业增加值亿元，增长；第三产业增加值亿元，增长。从数据上看，疫情后的温州经济恢复得不错。增速下的温州，民营企业正处于怎样的生存状态？他们对未来有何顾虑和期盼？月，澎湃新闻记者走进这个曾经的中国民营经济发展样本，寻找答案。一位企业主表示，“这次疫情及国际经济贸易的形势，对于企业其实也是一次体检，剩下的是体检合格的。企业的资金、管理状况各方面都比较健康，才能熬得过去。”调查温州老板没“躺平”;8;18;26;10006;0.002598440935438737
对许多美国人来说，美国疫情后的经济复苏感觉并不像复苏。尽管在过去几年里，通货膨胀率下降，家庭储蓄普遍增加，但许多有工作年龄子女的父母正在承受经济打击，以帮助养活子女。在周一公布的调查中，有超过一半的岁以上孩子的父母表示，他们已经牺牲了一些紧急储蓄和债务偿还来帮助他们的成年子女。在月中旬进行的这项调查中，约的受访者表示，这种经济援助削弱了他们自己的退休储蓄。调查结果暗示了几个月的物价上涨所造成的损失，甚至对那些从历史上炙手可热的就业市场中受益的适龄劳动人口也是如此。大约两年前，美国公民的岁大女儿和她的婴儿，还有岁女儿和岁最小的孩子，都住在一起。他说，从那以后，他的女儿用两位数的汽车贷款买了一辆年款的本田思域，然后把它弄坏了，除了每月美元的车贷外，还花了万美元的修理费。美国公民说：“作为父母，这很困难，因为就像你希望你的孩子做出正确的财务决定，但当他们做不到的时候，你也不想总是帮他们摆脱困境。”美国公民说，他和妻子每个月要付美元的抵押贷款，他们正试图给在当地一家福来鸡工作的女儿提供一些空闲时间，这样她就可以存点钱修车，并存下至少一年的房租。美国公民夫妇正在找全职工作攒钱，以支付岁女儿秋季开始上大学的学费。;10;163;173;10006;0.017289626224265442
中国经济增长的潜力，其实没有这么糟这次我们没有想着“跟国际接轨”如果说此前对于疫情结束后的经济增速有所失望是一个问题，那么，现在很多人的担忧又升级了。具体而言，到底经济动能不足是短期，还是长期？这反而成为了最大的困扰。不管美国人如何大打金融战、舆论战，人家也只能是顺势而为。如果我们本身确实不行了，那人家收割起来当然很麻利，这就像年的索罗斯。可如果我们底子还是可以的，内蕴还是强势的，只不过是短线遇到了点困顿。那么，无论美国人如何唱空、做空、布局，其实也无用。最好的例子，其实有关“中国崩溃论”的说法，已经在过去多年一直横行全球，也一直被扇耳光了。进一步来看，现在国内很多人不愿意消费和投资，也是因为这个问题。也就是说，这才是当下市场最大的非理性力量。所以，说什么提振信心、大国博弈、科技战、促进消费、地产是支柱产业等等，为什么市场反应平淡？核心就是因为，大多数人对于当下中国的经济动能看不懂，对于中国经济增长的潜能没把握。今天之所以我们必须写这篇文章，主要是前期留言区很多人的担忧，背后折射的也是这个问题。先亮明观点：无论短期如何，对于中国经济增长潜能依旧全面看好。不是因为担心喝茶才这么说，不是因为自己的大量核心资产在国内才这么说，而是人类几百年的经济史已经可以给到我们重要的答案凡是做过楼市投资的人应该都很清楚，尽管今年利率等信贷维度给了很多便宜，然而，就信贷审批的门槛和标准，放松力度根本不大。当大量不懂经的人大谈信贷已经如何如何松动经济却还没有起色的时候，其实国内信贷审批的门槛依旧是非常高的。这也就意味着，其实有形之手的防风险还在搞，而且根本没有松手。换个角度，只要我们现在的信贷审批门槛放松到年，或者是年下半年的时候，不要说楼市会起来，股市也绝对，国内的消费和投资马上牛逼到爆。这也提示我们，说救市举措全部用了，其实是不对的。核心的大量杀招根本没有用，而且，就像囤积子弹一样，一直囤在那里。魔鬼在细节啊从年开始，此前很多对于中国转型的提议基本上很多都被排斥了。第一个，就是学习美国人金融服务业驱动，目前已经被排除。因为，怕爆发金融危机。第二个，消费驱动经济增长，还是学美国人的。这里面，消费的能力在于赚钱能力，而赚钱能力在于劳动生产率提高，劳动生产率提高在于产业升级。所以，消费驱动的方案也被排除。第三个，向美国人下跪，祈求订单、原谅、市场。这个也已经不可能了因此，中国选择了一条最难的路，却又是美日韩法德曾经证明是唯一可以走向发达国家的路：血拼先进制造业因为，只有会做先进制造业，才可以真正提高劳动生产率，也就是单位时间内劳动力赚钱能力的提高。我们此前的文章专门说过，这几年进行的行业整顿，本质上是为了阶段性的压低新三座大山给民众的生活成本的压力。当时，就有人留言，说历史已经证明，这个是短期有效，长期反而会报复性增长。可是，大家有没有想过：或许人家要的就是“短期有效”呢？这就回到一个根本问题，为什么追求短期有效？很简单，产业升级是需要大量订单来支撑的，而订单光靠里面的内需肯定不行。这个不行，不仅仅是数量的问题，更是质量的问题。具体而言，出口创汇意味着你的产成品很有竞争力，否则全世界其它地方为什么买单？而国内内需，完全可以依赖有形之手的特许经营，然后就有订单了。前者是日韩法德模式，后者是印度、拉美模式，结果是不言而喻的。要真正获得产业升级，必须是出口牛逼，只有依托全球的需求、全球各地的供应链资源、全球散落各地的各种技术，才可以培育出中国本土的产业升级的真正成功。如同年我们入世那样，要实现这个目标，第一步，就是你的产成品要有“性价比”。那这个“性价比”哪里来？先把民众生活成本打下来，确保出口产品可以在国外形成“价格破坏效应”，能做的产业全部搞成白菜价，从而让发达国家产业大退步。也就是说，继续用最后的人口红利换来先进制造业的升级成功。很明显，上述过程，就是依赖国内大量民众的付出为代价的。历史上，朴正熙时代的韩国要玩水泥产业，上来第一波大打价格战，因为质量实在太差，没办法，最后韩国完全失败。然后，军政府的韩国发疯了，对外水泥价格再跌一半，对内水泥价格涨价一倍，把价格战往死里打。最终，韩国终于掌握了这个产业在当时的重要话语权，也为韩国大踏步进入重工业阶段的产业升级提供了机会。这就是经济史，极为残酷，对于当时的韩国人是严重的打击，可长期来看，又极大的有利于整个韩国国运的繁荣。我们完全可以想象，当时的韩国人也是各种骂娘，也是各种吐血，也是各种无望，可最终韩国的经济并没有崩溃，反而最后成为发达国家了。还有一部片子，大家也可以看一下，小李子演的《纽约黑帮》。上来就是两拨人如同中世纪一般对砍，可整个纽约就是在最最原始的混乱中，逐步走向繁荣、法治、自由的新世界。一代人有一代人的宿命，而我们这代人的宿命，其实已经非常清楚了，一点不以个体意志为转移。今天的中国最顶层战略已经非常清楚了：全面压低生活成本，同步举国体制海量资源投入产业升级，追求年这个最最关键的短周期内中国经济全面进入全球先进制造业强国的队伍。一边将全球各地的分工尽可能多的“内置化”到中国本国各地，变成国内分工，即，国内大循环。一边则是全面拓展海外经济势力版图，同步让我们的产业升级建立在全球的需求、资源、分工基础上。不得不说，从经济史上所有正反两面的经验教训来看，这是唯一可能走向成功的路。只要先进制造业在几年内有重大突破，那么，随之而来的就是全球经济模式的天翻地覆。届时，不仅是美国没法拦住我们，而且美西方国家的返贫也会是必然的。毕竟，全球大滞胀时代，谁有实体经济的综合竞争力，谁就可以笑傲江湖。我们甚至还可以换个角度来理解：中国用几年的吃苦时间，去搏未来成为发达国家的国运。能否大幅提高劳动生产率，这是体现一个国家核心竞争力的根本，而且这东西还跟军工战备能力也有关系。放眼全球，请问：哪一个经济体可以像我们的有形之手这样，疯狂实施产业升级？哪一个经济体的产业升级可以让美国人如此焦虑？哪一个经济体的有形之手可以操弄生活成本阶段性的下行来为产业升级保驾护航？此外，我们也要明白，冲击先进制造业的攻坚期，往往就是年。如果这个窗口期不能实现，也就没戏了。这个我们从英美日韩法德的经济史都可以看到，完全可以证明这点。而且，一旦我们这次冲击失败了，那就是第二次洋务运动失败了。这意味着什么？请君细品试问，我们还有其它选择吗？别人还会给我们第二次机会吗？只有死人才去躺平，活人只能搏命全球经济进入冰封时代，这就是时代最重要的背景。;4;40;44;10006;0.00439736158305017
说实话，怎么都没想明白，放开后的经济还不如疫情封锁起来的时候，能把股市，外汇，房地产搞成这样，现在就剩下最后一块遮羞布了，如果一线城市房产放开限购，房价还不如不放开刺激不起来，那确实很无力了，除了刺激房地产，没有其他的办法能搞好经济了;9;46;55;10006;0.005496701978812712
七夕后的垃圾桶感觉好浪费，华而不实不是说疫情过后经济下滑吗，不是说很多人挣钱不容易吗，看这垃圾桶，国人富有的很呐;1;1;2;10006;0.0001998800719568259
就说一嘴疫情后的经济政策吧。美国损失也很大，但是这个损失通过滥发美元万亿，得到了弥补。（仅仅疫情期间就超发了万亿）美国人是得到不少实惠的。单身补助、家庭补助，每家每户每个人摊下来都得到了几百刀到几千刀。美国的中小公司也是得到了扶助的，比如你公司在疫情期间没倒闭没裁员，就能申请到几万甚至十万刀美元的补助之类的。那么问题来了，如果社会的物质总量并没有增加，超发货币的恶果会马上显现物价飞涨啊因为你货币兑水了其他国家敢这么玩，经济立马崩溃给你看那美国为啥没有崩了呢？因为这些超发出来的万亿，可以在全世界买买买。很简单，美元绿纸，但是可以用这张纸买到黄金、石油、天然气、商品、人力甚至包括各国的优质资产。其实这万亿超发是引发了各国相当大的反弹的。都是一肚子的怒火。最早的美元是和黄金挂钩的，后来直接脱钩，说白了，美元的信用，就是美国的信用权力背书。再说白了，在今天已经演化为，美元，是霸王龙食物链顶端霸主的特权。美国经济打喷嚏，是全世界给它送药。如果美国进呢？那就是全球给它输血续命如果把地球想象成一个地球村儿，美国定义为村长，现在的村情就是，全村不管姓熊姓兔姓猫姓狗，除了村长一家子，都要被村长发的币收割。村长的几个连襟、血亲可能稍微好一点。村长随便印刷、划拉几张纸，全村各家各户就要把自己打猎来的肉、地里种的谷子、山里挖来的矿藏，统统缴纳上去。换来一堆绿纸。村长家如果没吃没喝的，就再给你划拉一堆纸。村里的其他家庭，为啥不敢滥发货币？你以为它们不想吗？你说呢？岚说世界史;39;270;309;10006;0.0308814711173296
，身为日本国民漫大，你不应该只满足于更一期休三期的摸鱼，你应该扛起日本乃至世界的，趁着的热潮继续拉动内需，建设疫情后的世界经济，比如说趁热打铁让百亿女主本篇也出来卖个，这样对大家都好;1;4;5;10006;0.0004997001798920647
昨天在小看了老蛮拉出来的我国经济数据，纵我这样心态贼好的，看完心都凉了半截。突然悟了，大难不死，必有后难。原来是形容疫情后的我国经济。;2;1;3;10006;0.00029982010793523883
股涨不了的主要原因一是疫情后的回血速度严重低于预期，停摆造成的损失异常巨大。许多行业有点缓不过劲的感觉。二是在经济恢复期实施注册制大量发行新股的决策是错误的，把社会有限的资源倾斜到了少数新上市企业的复苏上。;3;5;8;10006;0.0007995202878273036
今年年，是三年疫情结束后的一次大开放，人们不远万里去旅行，炫美照、炫美食、炫美景，哪怕经济低迷，终究抵抗不了一颗爱玩的心不过，我已然没了兴致，要旅行，就得和心爱的人浪迹天涯;2;2;4;10006;0.0003997601439136518
影响消费的因素有多种，现在正处在疫情后的休养生息阶段，利好经济的因素在慢慢积累。中国经济的大盘没问题，是稳的，人们对经济前景的悲观预期会改变，信心会回来，消费会慢慢起来，经济会慢慢复苏，前景是光明的。价值投资股票投资房地产政策;1;8;9;10006;0.0008994603238057165
疫情后的演唱会和旅游业一样，疯狂开展经济复苏就是榨干我兜里的最后一分钱吗;1;0;1;10006;9.994003597841295e-05
：在经历疫情后的初期反弹后，中国经济正在失去动力据报道，根据国际货币基金组织（）的最新报告显示，中国在经历疫情后初期的经济反弹后，其经济正在失去动力。表示：“在重启刺激措施后，中国的（经济）复苏正在失去动力。”报道称，可以肯定的是，在去年的政策结束后，中国的制造业和服务业消费在今年年初出现了反弹。但说，房地产行业的疲软打击了该国的投资，与此同时，外国需求滞后，青年失业率正在上升。“截至月份的经济数据证实，进入年第二季度，（中国经济）势头有所减弱。”报道称，国外需求疲软也打击了中国出口，月份中国出口同比暴跌。与此同时，国内需求也滞后，将中国置于通货紧缩的边缘。面对这种情况，中国领导层正在努力解决如何刺激经济复苏的问题，他们已经下调了利率。的报道说：“比目前设想的更强有力的政策支持特别是根据家庭收入或其他因素向其提供财政援助这可能会进一步维持复苏，并产生积极的全球溢出效应。但是，这样也意味着通胀压力的增加，以及货币政策的收紧。”;18;44;62;10006;0.006196282230661603
上一波市场的大主升，其实就是医药和消费数字经济的双主线。大概运行了半年之久。这里面的大逻辑，其实就是疫情开放（医药和消费强刺激）新的经济增长点。目前的主线也是一样。无论是还是地产，还是汽车。本质上的主题都是经济复苏。但是这个经济复苏，分为两个部分。是高成长，是困境反转展开;6;542;548;10006;0.054767139716170296
经济中国经济权威媒体报道，据今年月的报告，年和年全球经济皆预期会成长，跟疫情前相比仍然低迷。指出，在先进国家发展趋缓之际，新兴经济体引领了经济成长。“我们正在步入正轨，但还没有走出困境。”首席经济学家古兰沙（）向路透社指出，放眼展开;1;2;3;10006;0.00029982010793523883
山东大学生暑假社会实践复苏地摊经济，营造烟火气息随着疫情形势的好转，地摊经济逐渐活跃。为调查疫情后地摊经济的复苏情况，曲阜师范大学“践行红色初心，共铸时代之梦”实践队队员前往山东省临沂市朝阳社区进行实践活动。队员与摊主亲切交流，充分了解摊主生意情况并随后开展实践分享会，为打造烟火气息的社区献言献策。曲园学子三下乡大学生暑期社会实践;2;6;8;10006;0.0007995202878273036
中共中央政治局召开会议分析研究当前经济形势和经济工作中共中央总书记习近平主持会议新华社北京月日电中共中央政治局月日召开会议，分析研究当前经济形势，部署下半年经济工作。中共中央总书记习近平主持会议。会议认为，今年以来，在以习近平同志为核心的党中央坚强领导下，各地展开;13;17;30;10006;0.0029982010793523886
疫情期间很多企业坚持下来了因为当时做的不好都可以归结给疫情影响疫情放开后很多人却坚持不下来了因为觉得是自己错了我必须告诉你你确实“错了”因为做的不好还是疫情的后期影响不是你的错经济复苏需要时间不要绝望参考美国疫情一直发钞票放开也一年半才复苏很多人以为疫情放开就都没问题了当然不是至少什么都不做复苏需要的时间会慢大病痊愈肯定要休息调养身体才能恢复经济也一样大病初愈健康能不能跟得上很关键现在还在纠结地方债公务员降薪欠薪简直就是大病之后天天挨饿没营养病怎么好央行应该尽快出台强有力刺激政策这样还有一年时间大多的行业可能就会复苏普通人才能有希望有信心咬咬牙坚持坚持;26;208;234;10006;0.02338596841894863
财经投资外媒：中国经济正在温和且持续复苏国际社会关注中国经济走势外媒和国外投资机构日前热切关注中国经济走向。来自苏黎世瑞万通博资产管理公司的专家就认为，中国经济正在经历一种温和而持续的复苏。英国广播电视公司也认为，疫情后中国的消费复苏现在看来是最稳的，并扛起了经济增长的大旗。直新闻的微博视频;3;3;6;10006;0.0005996402158704777
天氣太熱提早派中段真的令我感動了哭出來粉絲專誠嚟到現場，放低錢給我，不停同我講：支持您繼續派下去四年幾來，區區派，月月派，不停派齋菜、米飯、糧食、飲品、白米、物資希望貧苦大眾能夠渡過疫情後嘅經濟衰退我將所有嘅功德迥向俾我所有嘅粉絲，我所有嘅朋友梁思浩香港的微博视频;36;145;181;10006;0.018089146512092744
市场早报：美国债务谈判未果；纽约联储行长重申美联储今年不会降息美国纽约联储行长对下月维持利率不变持开放态度，重申料今年不会降息。美联储理事称，信贷收紧是经济周期当前阶段的典型特征，相信经济能继续增长。隔夜要点金融市场翘首等待美国月通胀数据，环比料提展开;2;174;176;10006;0.01758944633220068
环球时报社评：中国经济一定会给乐观者丰厚回报中央政治局日召开会议定调下半年经济工作，中国及海外市场对其释放的重磅信号迅速作出积极反应。日，沪深大涨、恒生指数大涨，其中地产、科技板块表现亮眼。与此同时，在美国上市的中概股指数暴涨，创下个月最大涨幅，离岸人民币兑美元汇率持续反弹，亚洲股市也整体涨幅明显。这些都是市场信心的直观、初步体现，我们也相信，随着相关政策的不断落地，信心也将不断累积上扬，在中国社会乃至世界带来巨大回响。日的中央政治局会议，从最高层面为当前的经济工作指明了方向。这次会议给外界的普遍观感是，它的“干货很多”。会议毫不回避当前经济运行中面临的“新的困难挑战”，明确指出国内需求不足、一些企业经营困难等现实问题，提出了“要活跃资本市场，提振投资者信心”“通过增加居民收入扩大消费”“适时调整优化房地产政策”等具体政策方向。应当说，会议在顶层设计上全面、及时、深刻地回应了当前社会的重大关切。正是坚持实事求是和问题导向，让中国体制始终充满生机活力。党中央对当前经济形势的整体判断，和对接下来的经济工作部署，与中国老百姓的切身感受以及期待是一致的。这为中国全社会在接下来的爬坡过坎中拧成一股绳、发挥蓬勃的创造力打下了坚实地基。人们注意到，这次中央政治局会议特别鼓励干实事、求实效，比如“鼓励企业敢闯、敢投、敢担风险”“让勇于担当作为、善于攻坚克难的优秀干部脱颖而出、多作贡献”等。这既是一种呼唤，也可以说是时代的新机遇在新的发展浪潮中，无论是企业还是个人，只要敢拼敢闯敢担当，终将获得丰厚回报。这样的情况对中国社会来说并不陌生。疫情防控平稳转段后，中国经济恢复呈现出波浪式发展、曲折式前进的过程。这让一些西方舆论自认为“抓住了机会”，集中火力唱衰中国经济。我们不必理会他们怎么想，因为总有一些人打心底里就不愿意看到中国的发展进步。客观说，在全球经济低迷的情况下，外界普遍预期中国今年可以顺利完成左右的增长目标，这在主要经济体中，无论是发达国家还是新兴市场国家都是非常优异的表现。然而我们没有因为别人成绩差就给自己找偷懒的理由，反而是不断地自我革新、找出问题、校正方向。一个坚持发展为了人民、不断造福人民的中国，是绝对不可能躺平的。值得一提的是，中央政治局日的会议与此前出台的一系列政策方针一脉相承，从中不难看出中国的政策思路，并非“头痛医头脚痛医脚”地搞大水漫灌式“救急”，而是始终坚持从优化经济结构入手，提升社会的内生动力。它产生作用的过程或许需要一点时间，但必将转化为老百姓看得见摸得着的实实在在的发展红利。中国从来都是言出必行的。要看到，未来的道路注定不会一帆风顺，尤其是在世界经济整体下行的大环境下，中国如何推进高质量发展，给全体老百姓带来更多的机遇、收入和保障，其中的困难程度是可想而知的。但只要有直面问题的勇气，有敢于担当的胆魄，始终保持积极进取的姿态，我们就有信心乘风破浪、披荆斩棘。时间会证明，那些对中国经济保持乐观并积极有为的企业和个人，必将在时代的大潮中把握主动、赢得未来。;31;68;99;10006;0.009894063561862882
环球时报社评：中国经济一定会给乐观者丰厚回报中央政治局日召开会议定调下半年经济工作，中国及海外市场对其释放的重磅信号迅速作出积极反应。日，沪深大涨、恒生指数大涨，其中地产、科技板块表现亮眼。与此同时，在美国上市的中概股指数暴涨，创下个月最大涨幅，离岸人展开;38;69;107;10006;0.010693583849690186
一起做个题多选题（至少选两个）政治局年月日召开会议，分析研究当前经济形势，部署下半年经济工作。会议指出，我国经济具有巨大的发展韧性和潜力，长期向好的基本面没有改变。疫情防控平稳转段后，经济恢复是一个什么样的过程？时事杨加讲考研杨加讲超话决战考研展开;6;74;80;10006;0.007995202878273036
顾秀林：年时双螺旋发现年，基因重组技术已经出现。年后的年，美国宣布世纪属于生物技术，提前年提出全球生物技术战略。年，此战略已经实现为新冠疫情和全人类注射实验性疫苗。而我们的主管还在膜拜疫苗伪科学，努力为所谓的疫情大流行扇风，甚至搞了疫情经济。度反道展开;12;153;165;10006;0.016490105936438137
商会营苏大奖经济形势怎么看？经济恢复是一个波浪式发展、曲折式前进的过程会议指出，当前经济运行面临新的困难挑战，主要是国内需求不足，一些企业经营困难，重点领域风险隐患较多，外部环境复杂严峻。疫情防控平稳转段后，经济恢复是一个波浪式发展、曲折式前进的过程。我国经济具有巨展开;3;8;11;10006;0.0010993403957625424
中共中央政治局召开会议分析研究当前经济形势和经济工作中共中央总书记习近平主持会议新华社北京月日电中共中央政治局月日召开会议，分析研究当前经济形势，部署下半年经济工作。中共中央总书记习近平主持会议。会议认为，今年以来，在以习近平同志为核心的党中央坚强领导下，各地区各部门更好统筹国内国际两个大局，更好统筹疫情防控和经济社会发展，更好统筹发展和安全，国民经济持续恢复、总体回升向好，高质量发展扎实推进，产业升级厚积薄发，粮食能源安全得到有效保障，社会大局保持稳定，为实现全年经济社会发展目标打下了良好基础。会议指出，当前经济运行面临新的困难挑战，主要是国内需求不足，一些企业经营困难，重点领域风险隐患较多，外部环境复杂严峻。疫情防控平稳转段后，经济恢复是一个波浪式发展、曲折式前进的过程。我国经济具有巨大的发展韧性和潜力，长期向好的基本面没有改变。会议强调，做好下半年经济工作，要坚持稳中求进工作总基调，完整、准确、全面贯彻新发展理念，加快构建新发展格局，全面深化改革开放，加大宏观政策调控力度，着力扩大内需、提振信心、防范风险，不断推动经济运行持续好转、内生动力持续增强、社会预期持续改善、风险隐患持续化解，推动经济实现质的有效提升和量的合理增长。会议指出，要用好政策空间、找准发力方向，扎实推动经济高质量发展。要精准有力实施宏观调控，加强逆周期调节和政策储备。要继续实施积极的财政政策和稳健的货币政策，延续、优化、完善并落实好减税降费政策，发挥总量和结构性货币政策工具作用，大力支持科技创新、实体经济和中小微企业发展。要保持人民币汇率在合理均衡水平上的基本稳定。要活跃资本市场，提振投资者信心。会议强调，要积极扩大国内需求，发挥消费拉动经济增长的基础性作用，通过增加居民收入扩大消费，通过终端需求带动有效供给，把实施扩大内需战略同深化供给侧结构性改革有机结合起来。要提振汽车、电子产品、家居等大宗消费，推动体育休闲、文化旅游等服务消费。要更好发挥政府投资带动作用，加快地方政府专项债券发行和使用。要制定出台促进民间投资的政策措施。要多措并举，稳住外贸外资基本盘。要增加国际航班，保障中欧班列稳定畅通。会议指出，要大力推动现代化产业体系建设，加快培育壮大战略性新兴产业、打造更多支柱产业。要推动数字经济与先进制造业、现代服务业深度融合，促进人工智能安全发展。要推动平台企业规范健康持续发展。会议强调，要持续深化改革开放，坚持“两个毫不动摇”，切实提高国有企业核心竞争力，切实优化民营企业发展环境。要坚决整治乱收费、乱罚款、乱摊派，解决政府拖欠企业账款问题。要建立健全与企业的常态化沟通交流机制，鼓励企业敢闯、敢投、敢担风险，积极创造市场。要支持有条件的自贸试验区和自由贸易港对接国际高标准经贸规则，推动改革开放先行先试。要精心办好第三届“一带一路”国际合作高峰论坛。会议指出，要切实防范化解重点领域风险，适应我国房地产市场供求关系发生重大变化的新形势，适时调整优化房地产政策，因城施策用好政策工具箱，更好满足居民刚性和改善性住房需求，促进房地产市场平稳健康发展。要加大保障性住房建设和供给，积极推动城中村改造和“平急两用”公共基础设施建设，盘活改造各类闲置房产。要有效防范化解地方债务风险，制定实施一揽子化债方案。要加强金融监管，稳步推动高风险中小金融机构改革化险。会议强调，要加大民生保障力度，把稳就业提高到战略高度通盘考虑，兜牢兜实基层“三保”底线，扩大中等收入群体。要加强耕地保护和质量提升，巩固拓展脱贫攻坚成果，全面推进乡村振兴。要坚决防范重特大安全事故发生，保障迎峰度夏能源电力供应。会议指出，要以学习贯彻习近平新时代中国特色社会主义思想主题教育为契机，教育引导广大党员干部牢固树立正确政绩观，更好激发干事创业的积极性，让勇于担当作为、善于攻坚克难的优秀干部脱颖而出、多作贡献，以新气象新作为推动高质量发展取得新成效。会议还研究了其他事项。;2;2;4;10006;0.0003997601439136518
今天这市场，有一张特别棒的大名牌。那就是牛市会不会由此开启。很多人，是不是觉着太太疯了吧。但是我认为，至少心里要有这想法了，要有准备了。为啥呢，国外都是从疫情后一年，经济复苏的，大都也都是在经济拐点前启动。历史上，我们的提前启动周期，大概是先行经济个月。观察券商吧展开;1;553;554;10006;0.055366779932040776
成绩单来了组数据看中国上半年经济中共中央政治局月日召开会议，分析研究当前经济形势，会议指出，当前经济运行面临新的困难挑战，主要是国内需求不足，一些企业经营困难，重点领域风险隐患较多，外部环境复杂严峻。疫情防控平稳转段后，经济恢复是一个波浪式发展、曲折式前进的过程。我展开;1;2;3;10006;0.00029982010793523883
疯狂撒钱后的美国经济和股市。最近，美国财政数据显示，美国当前财年至月末（共九个月）预算赤字较上个财年同期增长。从疫情之后，美国就在大规模发钱，如今其实已经减少了这种直接发钱的行为，这也让美国度过了疫情的危机，股市和经济都十分繁荣。说实话，还真有点羡慕他们直接发钱的方式，我们做不到。毕竟胡锡进说过，给所有人发钱，等与没发。;15;146;161;10006;0.016090345792524486
老公你也要买吗，今天体谅了疫情后的国家经济;6;2;8;10006;0.0007995202878273036
诸城超话火出圈诸城这个夜市藏不住了人间烟火气，最抚凡人心。夜幕降临的龙都街道杨春社区杨春广场，灯火璀璨、人群熙攘、美食飘香。随着天气越来越热，“夜经济”成为城市一道亮丽的风景线。为缓解疫情后的就业压力，积极响应诸城市“优化营商环境”决策部署，激发广大居民的消费需求，展开;3;4;7;10006;0.0006995802518488907
经济的走势和疫情放开后的经济没有不一样的。大家看着就这么跌下去了。会好起来吗？不会，城投债和相关债务地方债务不解决，经济就统计个虚拟增长我就打瞌睡。;44;232;276;10006;0.027583449930041973
成都超话有没有暂时困难的朋友？告诉大家一个好消息，中国银行今年为了支持疫情复苏后的经济恢复，大力支持，只要有来源，没有当前都可，低至支持先息;1;2;3;10006;0.00029982010793523883
成都工作朋友的好消息经济告诉大家一个好消息，中国银行今年为了支持疫情复苏后的经济恢复，大力支持，只要有来源，没有当前都可，低至支持先息;2;4;6;10006;0.0005996402158704777
房地产买房滨湖的楼盘现在开盘都卖不动了？合肥房市真的是要凉凉了吗？据了解，青云阙这次开盘出现了众多弃选，同样，我们行分管的一个滨湖的楼盘，也是竞品质的，近期的两次加推都只能卖掉七八套这还是滨湖的楼盘吗？这到底什么原因造成的？真的是大家对疫情解禁后的经济期望值，不是太高造成的？目前看来，即使房贷利率降到以下，也不会房市产生决定性的作用，政府必须拿出一个强有力的刺激政策才可以了;5;10;15;10006;0.0014991005396761943
七年木有来过了此地，今非苷比，疫情过去后的繁华似锦，经济复苏之风亦似旋转风甘快回转呢，这里的居民非常之有礼，待人接物亦十分热情，希望香港，澳门回归之后继续繁荣昌盛，安康民众生活呢，;2;2;4;10006;0.0003997601439136518
肖战超话年代剧的意义是什么？看看记忆中的军大衣、供销社、四合院，只是导演要传达的表象；更深层次的，是让我们回顾过往，汲取更多养分，举一反三，推陈出新，用彼时的精神继续鼓舞当今的我们。面对当前复杂的国际形势、疫情后的经济复苏，肖春生们坚守正义本心，坚定走自己的道路，不轻易低头展开;5;3;8;10006;0.0007995202878273036
上半年最后一天年上半年真的过得飞快，这个话题里很多营销号又开始鸡汤了，尤其是有些官媒，写的内容，发的视频，讲真，有点脱离群众了。大家这半年都挺辛苦的，全世界人民都不好过，尤其是年轻一代，这半年他们过的也苦的要死。我记得去年，一帮不太聪明的人说疫情开就能解决经济问题。我当时说疫情，是疫情问题，经济是经济问题，有关联性，但不是因果关系，根本不会解决，一群人骂我不懂。我当时给大家的建议就是，年轻一批的，稳住工作，不要听网上那些大忽悠给你们讲这讲那的，一定要先活下来，活着才有机会，经济真的向好，你到时候再作调整也不迟。半年后，开放了，很多人继续对经济形势表达出完全缺乏常识的，盲目的信心。我当时也和大家说过，可能有小反弹，但之后会继续下降，然后失业潮到达高峰，还是有人骂我，说我唱衰经济。我属于自干五，但情况是啥样就是啥样，没必要回避问题，你不能因为说我热爱我自己的国家我就睁眼说瞎话。新的一年开始，线下短暂恢复，紧接着就是消费开始崩，失业人口开始迅速上升，各大厂开始裁员，中小企业就不说了，早就开始了。所以整个上半年，激励人心的事情真的不多，没有什么很有看点的事情能激励大家，而且下半年也不见得多好，不要继续下跌就不错了。尤其是现在的年轻人，你说什么事情能激励他们？能激励他们的真的也只有他们自己内心的一些东西了，就是一口气，全世界都难，自己千万别放弃，不要掉队，形势不好不是自己泄气的理由，他们其实就是靠着这些很朴实的东西在激励自己。官媒发的那些东西我认为没问题，有一些大事，有一些很了不起的事在发生，是关乎全人类命运的事，但是对年轻人的帮助不大，年轻人更多是活在具体的生活里，不是国家大事里。我前阵子写了微博，我说现在对年轻人唯一的，也是最大的好消息，可能就是很多小中产返贫了，很多人会和你们回到同一起跑线，现在对一些刚进入中产的下层，或者普通小康打击比较大，但这未来反而可能是对年轻人有点机会，两三年后会有新局面。所以看看着上半年，顶层的不说了，很多动作都停止了，休养生息，节能减排，中产的前半段，找不到什么投资点，生意不好做，投资没汇报，只能看着资产贬值，经过几年努力，刚刚进入中产的，还得动动心思守住自己的生活水平，别不小心一夜返贫消费降级了。年轻人更不谈了，现在活着的企业一大半都盼着工具人岗位的赶紧辞职，实习期个给你筛掉至少个。其实我没什么想说的，日子不至于说太惨，但确实比以前难一些，我就是单纯地想说：在座的各位能好好坚持到今天，都是好样的，都很好，这个很好不关乎什么宏大的东西，也没有什么雄伟的命题，我只是单纯的觉得，大家能一路这样走瞎来，都很了不起。;14;103;117;10006;0.011692984209474315
七月你好一不小心，月就结束了。抬望眼，苍天苍苍，白发苍苍，白云苍狗低下头，蒹霞苍苍，泪水流觞。回望股市，溯洄从之，道阻且跻。长太息以掩涕兮，哀股市之多艰过去年，我国的经济增速一直都是世界第一，每年的和税收都大幅度增长，房地产以及相关行业逼空上涨，全国上下展开;-1;4;3;10006;0.00029982010793523883
七月你好一不小心，月就结束了。抬望眼，苍天苍苍，白发苍苍，白云苍狗低下头，蒹霞苍苍，泪水流觞。回望股市，溯洄从之，道阻且跻。长太息以掩涕兮，哀股市之多艰过去年，我国的经济增速一直都是世界第一，每年的和税收都大幅度增长，房地产以及相关行业逼空上涨，全国上下，歌舞升平。但是，股市依然是别人的提款机，指数十年如一日的在点上下晃悠。走出了独立行情独立于经济之外，独立于法律之外，独立于经济学理论范畴之外。财富转移出中国之外疫情三年，一切就如摁了暂停键，顿失滔滔，行程码和核酸就如照妖镜一样，扫出了股市的真相，照出了一些买办和内奸的真面目。若果屈原今犹在，定会再跳汨罗江矮子里挑高个，粪土里面淘黄金。只要你还有一夜暴富的梦，那么你只能在这样的股市里，寻找自己的梦想的黄金。以梦为马，已负韶华；指股为牛，已负锱铢我要做股市的忠诚的信徒，和物质的短暂情人和所有以梦为马的诗人一样我不得不和庄家和机构走在同一道路上。我转山转水转佛塔，始终转不出股市今年上半年，大盘指数从元旦后开始的第一天的点，到了今天月日的点，指数是涨了点，但是，大部分的股，跌出了内伤只有中特估，以及人工智能，在上半年走出了牛市，其他板块跌跌不休。这就是结构性的牛市如果你上半年不拿有中特估和人工智能系列，即使你元旦后买入白酒，你都要亏得内裤都没了即使你年初持有人工智能，但是涨了一波之后，或者连续逼空上涨，大幅度震荡上涨的时候，或许你也拿不稳了，卖出锁定利空，那么就有了六月的捶足顿胸的悲天跄地的样子。这就是牛市时众人的心态。对于没有做中特估和人工智能系列的股的人，看着持有的股一直阴跌，看着人工智能天天大涨，外面的新闻整天吹人工智能要继续涨，有一部分人也崩溃了，就在煎熬中一气之下割肉卖出持有的股，买入人工智能，结果上周就集体闷杀。这就是股市。这就是股市该有的样子。愿赌服输疫情三年，经济确认了头部，经济增长开始减速，很多行业就水落石出房地产行业，下跌趋势明显，暂时没有那么大的资金和勇气去全面拯救房地产，所以绑架了经济的房地产，就拖着经济一路下滑。经济的三驾马车，投资、消费和出口。都同步拐头向下，那么，问题就出来了。投资，在四十年前，经济体量不大的时候，投资是刺激经济循环和增长很好的办法，虽然有稀释万元户的财富的副作用，但是，却是不断抽水的灌溉很好的办法但是，现在经济的体量大了，投资的效果就作用不大。更何况，铁路基本布局完毕，再次修铁路，意义不大，收入和投资基本是不正正比的，所以，铁路基建已经无效了。公路路网，基本布局完毕，再次几百亿的修建公路，大多数也属于重复修建，只会浪费，没有受益，哪怕提高到过路费一元一公里，依然是亏损的命运。剩下的大宗投资，就是光伏光电，水利运河之列的了。过去三年，大规模的投资光伏风电，虽然布局很好，但是并网发电不理想，所以，目前是减缓风电和光伏的投资。所以，这几年，开始大宗投资水利运河，即使作用不大，还是几百亿上千亿的投资。出口，由于美国的封杀，出口不断萎缩，有的企业为了能出口美国，就将光伏、电子、服装、家电企业转移到东南亚和墨西哥，组装出口美国，但依然被不断的封杀，所以，出口萎缩，无法作为经济增长点。消费，由于房地产的萧条，出口的萎缩，投资的减少，人民的收入锐减，所以，就出现了消费的萎缩现象，这是人民币贬值，大幅度的印钞的书本理论逻辑背道而驰这就是过分的市场化的结果。四页了，不写那么多了。下周一，月日，可能是新能源的电力和汽车系列，联袂大涨，徐徐展开秋季的序幕;1;4;5;10006;0.0004997001798920647
通过刺激股市来提振经济可行否？今年初市场预期疫情因素解除后消费会强力反弹，但上半年的经济运行表现明显低于预期，于是有很多人提出刺激经济的方案，其中就有人认为可以通过刺激股市来刺激经济。这不是什么新思路，早在多年前就试过了，年前也试过了，结果就不用说了，尤其是年前这次，差点搞出大风大浪。;26;47;73;10006;0.007295622626424146
海外昨晚美国的数据又是贼牛，无奈，疫情后，美国中低收入者赢麻了，薪资增速大幅提高，收入增速大于通胀，这也是老美高通胀，高利率下，经济还能有这么强韧性的底气，底层老板姓收入再提高。。。兜里有钱，有信心。这或许就是付说的，未来较常用一段时间，一边是高通胀高利率高增长，一边是低通胀低利率低增长的现实吧。指数横在着，那就没啥好聊的，后面看和机器人吧。去看看资料了，最近明显感受到，很多卖方都开始反思，反思当下，先宏观，后微观，其实就是一个浅显的道理，过了年放水提估值的日子，现在要勒紧裤腰带，不知道怎么投资了，给整不会了，天天被量化压在下面摩擦。早盘研报分享代糖行业更新：阿斯巴甜安全性生疑，代糖替代新机遇已现天风交运菜鸟自建物流点评;1;5;6;10006;0.0005996402158704777
如何抓住稳经济的牛鼻子以下文章来源于中国新闻周刊，作者陆挺在复杂的国际国内形势之下有别于往年，政府拉动经济的难度极高疫后经济复苏乏力，低于市场预期，但各界对于经济下行风险究竟有多大，尚有不小的分歧。对于复苏疲弱的原因究竟是什么，也缺乏共识。至于如何稳增长，市场几乎更没有什么共识了。我认为，疫后复苏的甜蜜期后，经济出现二次探底乃至螺旋式下滑的风险上升。复苏力度低于预期的主要原因是低估了房地产业暴跌所带来的负面连锁效应，低估了外部环境恶化所导致的外资和民间信心不足，以及高估了疫后报复性消费反弹的力度。在复杂的国际国内形势之下，有别于往年，政府拉动经济的难度极高。由于外部环境难以在短期内有较大改善，中央还是需要抓住房地产这个中国经济的牛鼻子，顺应城市化发展的趋势，同时拉动住房需求和促进住房有效供给，并通过恰当的要素市场改革来彰显其尊重市场和客观趋势的姿态。这样既能一定程度地恢复市场信心，又能以房地产为抓手来牵动总需求，还能改善民生，在短期内稳定经济增速，为中国经济面向高质量增长的转型争取宝贵的时间。图片图图虫创意经济复苏乏力的原因是什么？首先讨论当前经济二次探底的风险。官方制造业采购经理人指数已经从今年月份的高点下跌到月份荣枯线以下的。工业增加值、固定资产投资和出口同比增速分别从月份的、和下跌至月份的、和。剔除基数效应，和年同期相比，餐饮零售收入增速从月份的下跌至月份的。官方发布的房地产数据也在显著恶化。房地产投资、新房销售、开工面积和在建面积的同比增速分别由月份的、、、下滑至月份的、、和。和房地产业密切相关的粗钢和水泥产量同比增速分别由月份的和下降至月份的和。非官方数据则显示房地产数据处于更为糟糕的下滑之中。月份前个开发商的新房销售面积同比下降，而月份时还上升；若与年同期相比，则从月份的下滑至月份的。月数据更加不乐观，城新房销售面积在月份的前天同比下跌，而月份时还因为低基数上升了。月份财政收入同比下降，而月份还上升了，与房地产相关的税收收入同比增速更是在月份下降了。最新公布的今年端午节旅游消费金额比疫情前的年同期下降，而在五一黄金周期间还微升。当然，最近我国经济中也不乏亮点，尤其是在新能源行业，但综合来看，关键经济指标的环比和同比重新进入下行通道。若剔除基数效应，下半年增速恐怕要跌至以下。虽然因为低基数今年全年增速保的困难还不算大，但照此趋势，明年保的难度是不小的。我在月初发表的《特别的复苏，需要特殊的对待》一文中对此有详细讨论。我认为，复苏乏力的原因大致有四个：一是，尽管被疫情抑制的某些服务消费需求反弹不错，但耐用品消费需求疲弱，众人期待的在疫情中形成的超额储蓄并没有形成可持续的强势消费需求；二是，境外主要经济体因为通胀而进入加息周期，导致我国外需下行；三是，地缘政治风险加剧，境内外投资者信心普遍不足，其所面对的不确定性在上升，对产业和房地产投资以及消费都产生一定的负面影响；四是，尽管在去年年底中央推出条措施给房地产行业紧急松绑，但房地产业已经受到重创，沉疴积弊太深，各种管制过多，加上民众普遍信心不足。暴跌之后，房地产业在低位徘徊，对地方财政和整体经济的拖累越发明显。地方政府、房企和居民的资产负债表受损，不少地方融资平台被动缩表，而绝大部分民营房企在通过收缩业务来维持生存，因此中国经济总需求有面临螺旋式下降的风险。上述四条原因，互有联系，其中第三、四点尤为关键。详情链接：如何抓住稳经济的牛鼻子;3;15;18;10006;0.001798920647611433
港股、股、美债下半年怎么看？四位宏观首席大咖给出最新解读伴随疫情影响的消退，年的中国经济在加快构建新发展格局中不断迎来新气象、取得新成效，而全面实行注册制的推行，为中国资本市场发展打开了更广阔的空间。针对未来中国宏观经济的动态和走势，年月日，格隆汇举办的年格隆汇中期策略峰会中的宏观经济论坛的圆桌讨论环节，邀请到创金合信首席宏观分析师罗水星、德邦证券首席经济学家芦哲、信达证券首席宏观分析师解运亮、中国首席经济学家论坛成员郑后成，四位宏观首席大咖围绕最新经济形势进行了热烈讨论。上半年全球资本市场走势如何？主持人（罗水星）：欧美处在一个加息缩表的周期里面，但是像美股、德国股市、法国股市表现都还不错，这种背离和分化应该如何理解？郑后成：从分子端来看，美国经济呈现出非常强的韧性。一方面，就美联储长期跟踪的经济指标来看，美国达到，处于相对高位，与此同时，美国失业率为，处于相对低位。另一方面，制造业与制造业均跌到荣枯线下，但非制造与服务业均位于荣枯线上。非制造业与服务业对美股形成了较强的支撑。从风险偏好来看，从历史上看，美股每一次回调都是上车的机会，形成非常强的上涨预期，提升美股投资者的风险偏好。此外，美国的货币政策也具有非常强的周期性，可以比较准确的判断美联储加息和降息的趋势与时间。因此，当前美股走势包含了降息预期。股方面，从分子端以及风险偏好分析，当前宏观经济开局良好、稳中有进，但遇到了阶段性压力。板块方面，站在年年底，我们展望上半年，彼时看多黄金、教育、科技等三大板块。主持人（罗水星）：中美货币政策和中美利差，下半年会以什么样的方式去收敛？这种收敛，对于港、股方面会有怎样的影响？解运亮：从年、月开始，中美利差出现倒挂，其中中美的货币政策也是分化的。对于这种局面的形成，主要有两个因素：一个因素是中美央行货币政策背后的思路是不一样的；另一个就是基本面不一样。美国其实是一个数据依赖的货币政策的思路，且每次例会都会强调这一点。而中国央行，过去几年一直强调跨周期调解。这种思路不同，就导致美联储的政策的变化是大起大落的。因此在年疫情爆发后，美联储的利率骤降到。当美国经济开始复苏，就开启了史诗级的加息，因此出现大起大落的基准利率变化。而中国央行，坚持跨周期的理念，所以动作力度比较小，在年疫情最严重的时候降息的力度也较小，以至于年下半年开始经济复苏后，中国央行没有加过息。今年以来，美国经济的韧性超出市场的预期，背后的原因比如通胀强、就业强、以及美联储货币政策的刺激力度大。但除了这些因素外，其实还有一个重要因素，就是美国的人口增长。美国岁以上的人口增速在年开始提升，今年上升到以上。即便美国的资本、技术进步都是增长的，但仅靠人口的增长就能为它的贡献。此外，拜登上任后重新放宽移民政策，动力供给和需求改善，人口红利推高了美国经济的韧性，但同时美国的失业率也会上升，降息也是水到渠成的。最早今年底，最晚明年初，美联储可能就会降息周期。那个时候中美利差的倒挂，就会逐渐回归正常的状态。也就是说，在今年下半年市场就有可能提前交易美联储降息。这个对于股、港股等资产，都是非常大的利好。主持人（罗水星）：现在外资机构怎么看待中国资产？对于我们的资产偏好，在过去一段时间有没有在发生明显的变化？芦哲：年初能明显感觉到，比如桥水大举加仓新兴市场的基金，外资看多中国经济的表现。但现在预期和现实也出现了一定的差异。美股、日股的涨幅高于中国市场的表现。中国市场上，表现出来的结构性行情至少对机构投资者来说，赚钱是相对较差的，外资在在新兴市场的收益，确实不如在发达经济体上的收益情况。现在外资也在做关键时点的博弈和决策，确实上半年的表现相对较弱，但同时上调了对中国的经济增长预期，上调逻辑是货币、财政、地产等政策方面的调整。随着美联储加息告一段落，而下半年美国通胀水平在位置很难再进一步下行，我们到底是会度转向稳增长，强力的放松地产政策，还是渐进渐进式的微调？如果是渐进式，市场不会立刻转向大牛市，需要一定时间转化。所以，方向上来看，后续会有更多宏观政策的呵护，而末期临近是关键的需要研判的时期。主持人（罗水星）：欧美商业银行的冲击是不是结束了？接下来像美国商业地产的冲击会不会再次爆发或扩大，影响美国经济的软着陆？芦哲：年上半年，对于美国最大的风险，就是美国商业银行引发的短期银行业危机，包括传导到欧洲市场引发的系统性的金融风险，市场也是比较恐慌的。至少在初期的解决办法，美联储给予了临时性的扩表，给了流动性上的支持，美国监管部门，也协调大银行对小银行进行救助。这次危机没有对市场造成很严重的负面冲击，反而让美联储减缓了加息步伐，降低加息顶点。从流动性上讲，是有一定的正面的作用。但关于银行业，尤其是中小银行业的危机是否彻底结束，核心上是小银行缺少贷款。当现在政策利率达到目前的水平时，从居民端和企业端获得贷款的能力，本质上是发生了变化。同时，政策利率和货币利率已经达到这个水平，会比存款的收益情况和安全情况都要好。因此在基准利率没有下浮的情况下，银行业的危机是不可能彻底解决的。银行业的危机后，随之而来的就是商业地产问题，后续一定会面临冲击。但一个黑天鹅变成灰犀牛的时候，也未必是一件坏事。从长期来看，事情将如何处理，更多的并不是要靠美联储解决，大的货币政策，还是跟美国自身的经济周期和通胀水平有关。主持人（罗水星）：汇率会不会形成一个明显的掣肘？会否影响到国内政策的决策机制？郑后成：汇率不会成为国内货币政策后续宽松的制约因素。这一判断的依据主要来自以下几个层面：第一，从宏观经济政策目标体系看。包括货币政策在内的宏观经济政策目标主要有四个：一是保证本国经济健康持续的增长，这是一个国家宏观经济政策的首要目标；二是促进充分就业，就业是关系到国计民生的重大问题；三是促使物价稳定在一个合适的水平，避免通货膨胀和通货紧缩的诞生；四是保持国际收支平衡，国际贸易的过度顺差和逆差都会给国家带来一定的损害。汇率虽然未直接出现在目标体系中，但是与保持国际收支平衡高度相关，而国际收支平衡在目标体系位列第四，要服从于前三个目标，尤其是第一个目标，即保证本国经济健康持续的增长。第二，从货币政策最终目标看。根据《中华人民共和国中国人民银行法》第三条，中国人民银行的最终目标是保持货币币值的稳定，并以此促进经济增长。币值稳定包括两个方面：一是对内币值稳定，体现为以当月同比为代表的通货膨胀稳定；二是对外币值稳定，主要体现为人民币汇率的稳定。要注意到，保持币值稳定的目的是以此促进经济增长。也就是说，促进经济增长是央行的根本目标。第三，从宏观逻辑上看，人民币汇率贬值通常发生在我国宏观经济承压的背景下，而国内货币政策宽松也是对宏观经济承压的应对与逆周期调节。从货币政策实践看，央行是否在人民币汇率贬值，尤其是破的北京下实行宽松的货币政策？在年月、年月、年月，央行均在人民币汇率破之际降准或降息，包括此次月日下调天期逆回购利率。第四，汇率反映的是两国之间宏观经济的基本面。一是采取宽松政策在短期内利空人民币汇率，但是随着传导效应的实现，宽松货币政策助力宏观经济企稳向好，将对人民币汇率形成利多。二是随着时间的推移，美国进入主动去库存阶段，而我国进入被动去库存阶段，我国宏观经济基本面强于美国，人民币汇率中期具备升值的基础。聚焦投资线索：高端制造、、中特估主持人（罗水星）：传统的高端制造，新能源能不能抄底？新的超端制造，如芯片、半导体，最近能不能去？解运亮：像新能源、光伏，未来要规避风险；像芯片，可以适当布局。今年一季度我国产能利用率，回到了年年的水平。从产能周期的角度讲，我国又出现了产能过剩的现象。年、年的时候，我国工业产能利用率低于，认为产能过剩非常严重。今年一季度，产能利用率又低于，但是这次是高技术制造业产能过剩，尤其是新能源汽车、光伏等。资本市场上，这些板块也一直在调整，因此这些板块虽然叫高端制造，但还是要规避的。主持人（罗水星）：现在还能追吗？还是回调再追？如果要追，是追国内的还是美股的？芦哲：全球来看，不论股还是美股，今年涨得最好的都是，但是上涨的逻辑是不一样的。第一，科技变革的可能性从目前看起来，可能是未来年，最有可能改变人类生产模式的一项科技。但是也不能百分之百确定，资本市场交易的就是预期和前景。前景这些东西。第二，中国有特殊的地方。年初预期强的，如数据周期、消费等，走势较弱，导致市场在买无可买的情况下，没有基本面。很多行业在没有基本面驱动的情况下，只能交易有概念、有想象力空间的板块。所以当整体股市表现好的时候，可能会差一些；当大盘表现不好，对经济数据、政策预期弱，表现性反而好一些。更多的问题是在于基本面的交易逻辑能不能回归，像月政治局会议这样的重要的政策节点，能不能释放出强劲的高层对稳增长政策的加码，这是核心关键的问题。如果加码强劲，周期板块包括机械等，都会有更很好的表现；但是如果政策力度与市场预期有差异，的持续度是会继续的，到是没有问题的。主持人（罗水星）：关于中特估，我自己作为一个公募基金经理，从去年开始也一直关注。像公募基金去买一个东西，首先要看政策是否有真金白银的支持，如果没有就是以提振信心为主。最近也发行了一些中特估或央企改革的，从募集资金来看，在今年的情况下是可以的。第二，要看它只是一个概念还是有基本面支撑。我们可能更多的关注是到底有没有业绩，从这个角度讲，一要有资金支持，二是有盈利的支持。此外，很多人认为中特估像是那种挖煤、搞基建的东西，但它其实不止这些，它还包括电信运营商、数据要素等相关的，或是中药也是新经济的一部分。今年盈利是稀缺的。如果在大家没有盈利的时候，你有十几的盈利是很不错的，加上资金支持、基本面的保证，在调下来后都是可以关注的。不管是中特估、、高端制造，还是拔估值为主，因为全球总需求都不足，所以相关的东西都可以做一些交易。如何看待下半年？对于下半年的展望，郑后成表示，下半年看好即将到来的美债牛市。如果看空美国经济，美联储要降息的话，美债可能面临一个比较好的机会。虽然目前美债价格处于低位，美债利率处于高位，但是美债利率的下行是确定性事件。其次，继续看多国际金价，只要美联储没有降息之前，国际金价就可以看多。最后，股市场上半年承压，年有望迎来不错的业绩。年下半年可能处在这两个阶段的过程当中，下半年可能比上半年要好。解运亮也指出，看好股、港股和美债。对于股的逻辑，他判断三季度是中国经济的底，市场底领先于经济底，因此月应该是股的底。美债的逻辑，在于下半年市场可能提前交易美联储降息预期。港股的逻辑就是中国经济复苏和美元流动性改善。芦哲则认为，最好的资产还是利率。债券可能会挑战的水平。以后，尤其是月份以后，开始转向股票，那时股票的行情才能开启。;1;1;2;10006;0.0001998800719568259
年月至日，世界经济论坛第十四届新领军者年会（又称“夏季达沃斯论坛”）在天津举办。这不仅仅是疫情后夏季达沃斯的首次线下论坛，还是一次思想盛宴。人工智能、绿色转型、气候变化今年有哪些热点话题被讨论？全世界都如何从中国发展中受益？头脑风暴下，各界大咖提出哪些观点？凤凰网带你一图回顾这场夏季盛会。达沃斯在天津;4;13;17;10006;0.0016989806116330202
朱民：中国必须寻找长期的经济增长引擎月日，据世界经济论坛官方微博消息，中国国际经济交流中心副理事长、世界经济论坛基金董事会成员朱民认为，面对疫情后充满挑战的市场环境，我们应当在平衡供需、确保不发生系统性风险的前提下，推动结构性改变，从房地产、贸易到制造业，中国必须寻找长期的经济增长引擎。整体而言，中国的经济仍是往前、往上、稳步增长的。界面的微博视频;1;2;3;10006;0.00029982010793523883
朱民：中国必须寻找长期的经济增长引擎月日，据世界经济论坛官方微博消息，中国国际经济交流中心副理事长、世界经济论坛基金董事会成员朱民认为，面对疫情后充满挑战的市场环境，我们应当在平衡供需、确保不发生系统性风险的前提下，推动结构性改变，从房地产、贸易到制造业，中国必须寻找长期的经济增长引擎。整体而言，中国的经济仍是往前、往上、稳步增长的。;1;0;1;10006;9.994003597841295e-05
转今天疯转的野村证券辜朝明在香港东吴策略会上的发言，茶余饭后可看，刚刚汇率又崩了：、日本的经验证明资产负债表衰退风险巨大，唯一的有效手段就是持续政府财政支出来平衡企业和居民部门不借贷。目前中国的优势是提早认识到资产负债表衰退的风险和措施，可能不会有日本那样年的持续衰退。缺点是中国难以像日本再衰退期间仍然保持了出口、高端制造行业的稳定发展（日本年代后实体经济和并没有明显受影响）。中国面临的挑战，可能比日本年前面临的挑战更大：中国的地缘政治风险可能会导致失去世界经济体量的西方市场，叠加人口提前衰退（日本在年人口拐点）、企业部门于年不再借贷扩表、疫情政府居民及企业资产受损严重。中国扭转陷入中等收入陷阱的概率很低。我们拿什么跟年代日本比？日本什么国际环境，我们现在是什么国际环境。日本富豪屯富于海外，我们富豪逃逸转移至海外。日本年代老百姓富到什么程度，我们是家家户户负债，家家户户房贷。日本年代年轻人可以安心躺平，我们的年轻人主要靠快递和外卖实现就业，过去十年我们到底干了些什么把经济干成这个鬼样子。;1;0;1;10006;9.994003597841295e-05
聚焦第十四届夏季达沃斯论坛打卡第十四届夏季达沃斯论坛第十四届夏季达沃斯论坛日在中国天津开幕。这是因新冠疫情而延期后，夏季达沃斯论坛时隔四年首次在中国恢复线下举办。本届论坛主题是“企业家精神：世界经济驱动力”，来自全球多个国家和地区的约名各界代表参会，就后疫情时代重新激发亚洲和世界各地的创新活力和企业家精神、探寻经济复苏之道展开对话。新华网的微博视频;2;7;9;10006;0.0008994603238057165
今天野村证券首席经济学家辜朝明在东吴策略会上的发言：中国扭转陷入中等收入陷阱的概率很低，可能失去世界经济体量的西方市场、日本的经验证明资产负债表衰退风险巨大，唯一的有效手段就是持续政府财政支出来平衡企业和居民部门不借贷。目前中国的优势是提早认识到资产负债表衰退的风险和措施，可能不会有日本那样年的持续衰退。缺点是中国难以像日本再衰退期间仍然保持了出口、高端制造行业的稳定发展（日本年代后实体经济和并没有明显受影响）。中国面临的挑战，可能比日本年前面临的挑战更大：中国的地缘政治风险可能会导致失去世界经济体量的西方市场，叠加人口提前衰退（日本在年人口拐点）、企业部门于年不再借贷阔表、疫情政府居民及企业资产受损严重。中国扭转陷入中等收入陷阱的概率很低。;7;29;36;10006;0.003597841295222866
今天辜朝明在东吴策略会上的发言：、日本的经验证明资产负债表衰退风险巨大，唯一的有效手段就是持续政府财政支出来平衡企业和居民部门不借贷。目前中国的优势是提早认识到资产负债表衰退的风险和措施，可能不会有日本那样年的持续衰退。缺点是中国难以像日本再衰退期间仍然保持了出口、高端制造行业的稳定发展（日本年代后实体经济和并没有明显受影响）。中国面临的挑战，可能比日本年前面临的挑战更大：中国的地缘政治风险可能会导致失去世界经济体量的西方市场，叠加人口提前衰退（日本在年人口拐点）、企业部门于年不再借贷阔表、疫情政府居民及企业资产受损严重。中国扭转陷入中等收入陷阱的概率很低。;3;9;12;10006;0.0011992804317409553
国际关系考研超话国小政词典中德经济技术合作论坛经济全球化中德经济技术合作论坛（）当地时间月日下午，国务院总理在柏林同德国总理朔尔茨出席第十一届中德经济技术合作论坛闭幕式并发表讲话。中德经济、企业界多名代表出席论坛。总理表示，在当前变乱交织的形势下，加强合作是互利共赢的正道，也是应当全力去做的正事。要把经济技术合作作为国际合作的重要基石，把握经济全球化的大势，坚定支持自由贸易，促进人类共同繁荣发展。总理指出，中德经济技术合作的成果和经验弥足珍贵。中德建交五十多年来，开展了广泛而深入的友好合作，特别是经济技术合作最活跃最积极，逐渐形成了全方位、多领域的合作新格局。中德合作能取得这样的成就，关键在于双方坚持相互尊重、求同存异、互利共赢、务实创新的合作精神。中德应携手深化经济技术合作，为加强中欧互利合作、推动全球发展作出示范和引领。朔尔茨表示，德不会走逆全球化道路，将坚持开放政策，继续加强与中国合作，推动两国合作在疫情后加速发展。德方愿同中方通过沟通对话，解决双方合作中存在的问题。出席中德经济技术合作论坛前，总理和朔尔茨还共同出席中德企业家圆桌会，同多位中德企业家代表座谈交流。总理表示，应对困难挑战，合作是唯一的出路，也是最好的办法。政府应该为企业经营创造良好的环境、稳定的预期，让企业按照市场和经济规律研判和应对风险，在开放合作中实现互利共赢。中国将在新的起点上不断扩大高水平对外开放，持续打造市场化、法治化、国际化一流营商环境。希望德方继续保持市场开放，为中国企业赴德投资营造公平、透明、非歧视的营商环境。中德在数字经济、人工智能、绿色发展等领域合作空间广阔、大有可为。相信在两国企业家共同推动下，中德合作一定能不断取得新的成果。与会双方企业家表示，中德是重要合作伙伴，两国企业界支持开放政策，主张充分发挥中德经济顾问委员会等机制作用，加强交流互鉴，深化在创新、数字经济、绿色发展等领域高水平合作，实现互利共赢、共同发展。参考来源：中国政府网、新华社;1;9;10;10006;0.0009994003597841295
今天野村证券辜朝明在东吴策略会上的发言：、日本的经验证明资产负债表衰退风险巨大，唯一的有效手段就是持续政府财政支出来平衡企业和居民部门不借贷。目前中国的优势是提早认识到资产负债表衰退的风险和措施，可能不会有日本那样年的持续衰退。缺点是中国难以像日本再衰退期间仍然保持了出口、高端制造行业的稳定发展（日本年代后实体经济和并没有明显受影响）。中国面临的挑战，可能比日本年前面临的挑战更大：中国的地缘政治风险可能会导致失去世界经济体量的西方市场，叠加人口提前衰退（日本在年人口拐点）、企业部门于年不再借贷阔表、疫情政府居民及企业资产受损严重。中国扭转陷入中等收入陷阱的概率很低。;5;34;39;10006;0.003897661403158105
闻鼓论津世界聚焦天津：夏季达沃斯论坛的四个“新”闻鼓论津世界聚焦天津：夏季达沃斯论坛的四个“新”年，世界经济在曲折中复苏前行，科技革命和产业革命的深度融合点亮未来增长之路。以亚洲为代表的世界发展新势力展现出巨大的内生增长前景，以数字经济为标志的新模式正在引领全球经济重启新增长。如何获取来自新兴产业的增长新动能，让以数字技术为代表的创新要素发挥最大驱动力，本届夏季达沃斯论坛以“企业家精神：世界经济驱动力”为主题聚焦世界关注，向世界展示中国开放、包容、创新、学习、共赢的发展姿态，为塑造更加公平、可持续和有韧性的全球经济创造凝聚智慧、达成共识的交流对话平台。探寻世界重启增长新动能当下，世界经济面临复苏艰难的困境，人类社会现代化进程又一次来到历史的十字路口，世界各国渴望为经济增长注入新的动能。作为全球第二大经济体，中国经济活力和潜能的释放已经成为世界经济复苏的强大动力和信心来源。围绕着如何挖掘和释放全球重启增长的新动能，本届达沃斯论坛为世界各地的政界高层、工商界领袖和不同领域业界翘楚提供了碰撞智慧、交流思想、分享未来的对话平台，尤其是来自中国的市场力量、声音话语、实践方案将直接影响世界经济走向和国际市场脉动。立足中国式现代化新场景当今世界，多重挑战和危机交织叠加，发展鸿沟不断拉大，各国探索现代化的道路充满艰辛。从世界视野看由“现代化在中国”到“中国式现代化”正是中国在现代化发展过程中为世界呈现的新气象。本届夏季达沃斯论坛将现代化发展的需求作为切入，聚焦全球经济社会科技深刻转型的新场景、新要求，以中国式现代化提供从外源向内生的发展新模式，不仅为广大发展中国家独立自主迈向现代化提供了重要示范和全新选择，更是世界在保持开放合作、和平发展主基调下的又一次发展道路选择的中国演绎。关切全球发展实践新方案如何让企业和社会从冲击中更快更好地恢复需要机遇，更需要发展的“韧性”，世界都期盼着符合时代趋势的未来战略引领。“创新、开放、绿色”不仅是本届年会的热词，更是我们希望通过论坛这个平台用中国式现代化的发展实践向世界贡献中国方案。京津冀区域正在努力成为中国式现代化建设的先行区、示范区。本届夏季达沃斯论坛在天津举办，不仅为京津冀承担先行探索重要使命提供了高水平的沟通桥梁和全方位的展示窗口，更是汇聚全球要素资源和智慧支撑，以京津冀协同发展“从全局谋划一域，以一域服务全局”的纵深布局为世界提供中国方案的最好区域实践，这正是后疫情时代中国对世界发展新趋向的积极回应。搭建全面开放共赢新平台今年是全面贯彻落实党的二十大精神的开局之年，天津组织实施推动高质量发展的“十项行动”，全面推动建设社会主义现代化大都市，在新时代为发展大局探索拓新破题的发展路径。本届论坛将是天津服务国家重大战略、主动融入世界市场、推进深度对外开放、汇聚全球发展动能的重要契机。依托区位、交通、文旅资源等发展优势，紧扣科技发展和产业革命的前沿热点，聚焦数字经济、绿色经济、创新技术等重大议题和实践需求，搭建政产学研多层次务实开放合作平台，不仅有助于天津利用好国际国内两个市场、两种资源，不断提升贸易投资合作的质量和水平，更是天津大力发展会展经济，加快建设“北方会展之都”的主动作为，向世界传递出天津创新发展的积极信号。在开放包容、充满活力、动能强劲、前景可期的渤海之滨，迎着全球积极对话合作的新愿景，在融合创新增长的发展新机遇中，本届夏季达沃斯论坛共同期待世界经济拓展增长新空间、燃动增长新引擎;1;0;1;10006;9.994003597841295e-05
不知不觉已到年中，年走过了一半。半年前，疫情放开，人们欢欣鼓舞，期待着经济来一场复苏，年后各地楼市的飘红，似乎在示意着未来可期。没想到，现实很骨感，从月中旬开始，各地楼市后劲越发不足，几乎给所有地产从业者泼了一盘冷水。深圳，作为全国楼市领涨的“急先锋”，深圳长期扮演了全国楼市“晴雨表”的角色，无论是自住或者投资，深圳的新房市场情况往往能反映当前普罗大众对于房地产的态度。那么年上半年，深圳的新房市场表现如何呢？是强弓末弩，还是蓄势待发？改善撑场，人才房搅局上半年深圳楼市“大怪象”;2;7;9;10006;0.0008994603238057165
他们争相访华，因为中国“不可或缺”“从新加坡主权财富基金新加坡政府投资公司（），到汇丰银行（）和高盛集团（），再到美国私募基金巨头黑石集团（），至少已经有位跨国企业高管前往北京，与中国主权财富基金中国投资有限责任公司（）的高管会面。”月日，香港《南华早报》如此报道近期跨国企业高层上演的“访华潮”，事实上，中投公司在此期间还接待了锐盛投资公司（）、法国巴黎银行（）、安联集团（）和德高集团（）的企业高管。在这些会面中，中投公司董事长彭纯和总经理居伟民同来访者讨论了中国和全球的经济前景，以及资本市场格局。这些跨国企业在中国的投资足迹日益扩大，中投公司也表示，双方在分享信息后，还承诺就投资机会展开更深入的合作。“对于那些试图解读中国经济目标背后思想的资金管理者来说，这种洞见是无价之宝。”《南华早报》还强调，这些访问突显出，在地缘政治风险一触即发之际，从当地了解中国经济非常重要，许多华尔街分析人士仍然看好中国和中国经济的前景。有投资分析师也指出，越是关键时刻，投资中国对于全球投资者而言也越发重要，他们不可能完全忽视中国，因为没有任何替代者可以代替得了中国资产的优质表现。总部位于美国华盛顿的国际金融协会的经济学家罗宾布鲁克斯（）和乔纳森福尔顿（），在月日的一份报告中表示：“中美之间紧张局势的升级引发了许多问题。”除了对去全球化的担忧，“随着外国投资者削减风险敞口，去风险化也受到关注”。总部位于加拿大蒙特利尔的艾摩宏观公司的中国市场策略师王岩，上月则在一份报告中表示，在中国优化调整新冠疫情防控措施并开放后，包括美国的一些西方盟友在内，全球商界和政界领袖几乎立刻蜂拥至中国，“这证明了中国在全球商业版图中不可或缺的作用”。这些领导人，包括锐盛投资公司的联合创始人兼董事长安东尼雷斯勒（）、新加坡政府投资公司首席执行官林昭杰（）和汇丰集团主席杜嘉祺（）等人。今年月，黑石集团董事长苏世民（）也前来访华，并与中投公司董事长彭纯等人会面，双方就全球经济和市场格局，以及重点投资领域交换了意见，并承诺加强沟通与合作。今年月底，彭纯还接待了全球最大户外广告企业、总部位于法国巴黎的德高集团，这家公司入股了经营着中国最大公交车候车亭媒体业务的白马户外媒体公司，这从某种意义上代表着德高集团的战略扩大其在关键市场之一中国的业务范围。其他前来访华并拜访中投公司的，还包括法国巴黎银行董事长乐明瀚（）、安联集团首席执行官奥利弗贝特（）和高盛集团董事长苏德巍（）。其中，苏德巍与彭纯就全球投资环境和中国经济潜力等议题交换了意见，就推动合作共赢达成共识。除了美欧知名企业，总部设在巴林的恩伟资本（），其董事长穆罕默德阿拉尔迪（）同样访问了中国，彭纯与他就全球经济金融形势、中国经济发展前景、海湾国家投资机会、双方潜在合作等议题交换了意见。去年月，这家管理着大约亿美元资产的中东企业，与总部设在香港的冯氏投资有限公司（）合作，推出了一只亿美元基金，以投资粤港澳大湾区。《南华早报》最后强调，以上这些访问突显出，在地缘政治风险一触即发的关键时刻，从当地了解中国经济非常重要，许多华尔街分析人士仍然看好中国和中国经济的前景。分析师王岩指出，在中美地缘政治紧张局势加剧以及金融“脱钩”的背景下，对于全球投资者而言，投资中国变得更加重要而不是相反。他表示：“完全忽视中国是不现实的。没有任何替代者可以精确地模仿中国资产的（优质）表现。”;9;93;102;10006;0.01019388366979812
正在直播亚洲制造业的复苏制造业将成为后疫情时代经济复苏的关键驱动力，继续在亚洲经济活动中发挥及其重要的作用。面对各行业所在区域呈现多元化的趋势，亚洲制造业在迎来复苏的同时如何通过全球合作确保其持续增长？本场会议与世界经济论坛先进制造业和供应链中心正在进行的工作直接相关。夏季达沃斯世界经济论坛的微博直播;1;8;9;10006;0.0008994603238057165
为何澳洲拼命加息，中国却在降息？高失业率，工厂倒闭，中国经济摇摇欲坠澳洲和中国是亚太地区的两个经济大国，但在新冠疫情后的经济复苏中采取了截然不同的方式。据澳洲新闻集团报道，当澳洲和全球其他国家一样选择加息时，中国却是靠降息来提振摇摇欲坠的经济。中国央行日前进行了近个月以来的首次降息，与此同时，包括高盛在内的华尔街银行下调了对中国经济增长的预测。网页链接;-3;3;0;10006;0.0
白鹤滩特高压月日凌晨，随着国家电网千伏钱塘江换流站双极高端系统顺利完成试运行期间各项测试，我国“西电东送”重点工程白鹤滩送浙江千伏特高压直流输电工程全容量投产，输电能力提升至万千瓦。面对气象预测的“史上最热年”及疫情防控政策调整后的经济恢复，这条电力“高速路”全部通道的打通将为今夏浙江乃至华东地区的电力供应提供有力保障。;1;1;2;10006;0.0001998800719568259
大家都说经济形势不好，朋友开餐厅撑过了疫情，疫情结束餐厅也倒闭了；安装洗手间的帅哥说疫情期间他的单很多有时还忙不过来，疫情后的现在活越来越少了，入不敷出，再这样下去要举家回老家了可我看疫情结束后的每一场演唱会几乎场场爆满，票价多高都秒光，周末节假日出去吃饭都要排队等位。有点搞不懂;3;5;8;10006;0.0007995202878273036
我国青年失业率处在高位多万的确不是个小数字，而且还不包括其他年龄段的失业人数。现在国内经济处在疫情后的恢复阶段，而且还受到外部环境不确定因素的影响。要解决青年失业问题，需要全社会的共同努力，青年人也要先就业后择业，共克时艰。;1;0;1;10006;9.994003597841295e-05
最近这个公积金购房政策，可谓是一天一个利好，先是提高贷款额度，现又可以直接提取付首付，即使政府把公积金玩出花来，似乎也不曾有人买单。这直接凸显的就是房地产市场极度疲软，全国二手存量房市场几乎都在降价。经过了疫情三年，疫情放开后各行业并没有出现“百家争鸣，百花齐放”的局面。反而是人们认清了生活的本质，不敢乱投资，因为现金流在绝对危险的时刻是可以直接保命的，中国人大多都是骨子里的胆小慎微，尤其是父母亲这一辈人，她们大多没有理财投资的观念，有钱只知道存银行吃利息。所以就目前中国财富来说至少有百分之六十是掌握在她们这一代人手里的。这也是前两天六大行纷纷下调银行存款利率的一个重要因素吧。单从刚需角度看，现在房产市场的主力军是后们，都说中国的后们是“最不惧”的一辈，他们职场不惯老板，情场上不婚主义盛行。你让这一辈秉着及时行乐主义且本就过度消费负债的群体再去贷款买房，再一个就是拿着千的收入还着的月供怕不是在做春秋大梦哦。从改善性住房角度看，现在政府在疯狂鼓励二胎，三胎，其效果慎微。家庭在没有新人口的情况下，人均住房面积似乎也没有那么重要了，房子够住了，也不会再考虑置换大房子。从学区房角度看，学区房受政策影响大，且多地相继传出和实施了取消学区房政策，人们不会在一味傻傻多花几百甚至上千个大不溜在学区房上。这也直接成为了学区房滞销的重要因素。房地产市场下行，是当今社会的缩影。就业，人口出生率、教育等等。中国经济在过去十五二十年里飞速增长，政府疯狂卖地，开发商疯狂盖楼，普通群众跟风炒房投资，这一系列的操作导致中国楼市如今这个局面。虽说中国是世界第二大经济体，但是有没有想过这其中有多少泡沫在楼市里，真正在社会经济的其他方面又有多少称之为世界第二？饮鸩止渴终究会毒发攻心，倒不如多关心民生，想办法招商增加就业岗位，就业形势明朗了，生活压力小了，人民幸福感强了，房地产自然会有人接盘，矛盾自然就解决了。当然，这个过程不会简单，作为普通群众我只能提供我的思路，至于怎么做，还是找那些万里挑一行测申论答的更好的公务员们去想法子吧房贷利率下行对住房需求有何影响房地产政策中国经济如何看待房贷利率持续下行;2;2;4;10006;0.0003997601439136518
今天央行下调了天逆回购利率，那号公布的月大概率也会下调。增量房贷利率也会立刻下浮，存量房贷大多要到明年月日才能“减负”。现在能明确断定，后疫情时代中国经济复苏不是形反转，是型还是型就看下半年了从目前大家情绪面看，都不肯消费不愿借贷，型可能性高于型。有人问，未来中国会降低到零利率甚至负利率吗？长期看，很有可能。;1;0;1;10006;9.994003597841295e-05
股票按目前情况日经已经走出月线第四浪了，正所谓有必有。时隔多年，日经很有可能冲破点。创历史新高。除了大股市就是一个国家经济的晴雨表尤其是美元强挂钩国家，当这些国家从后疫情时代走出来，从以前的经济危机走出来，从以前的房市危机走出来。大依旧自娱自乐？你告诉我这叫国富，还是民强？;-1;0;-1;10006;-9.994003597841295e-05
昨天去常去的理发店理发，理发的小伙子阿辉几年前自己出来创业开的理发店。我问他疫情结束后生意恢复的怎么样，有没有年的。他说还要更惨，每天的营业额只有年的。主要是烫发染发的少了，仅仅是剪头不挣钱。房价跌、股市跌、工资跌，很多人就不愿意消费了。阿辉说他现在也消费降级了，原来总是去饭店呼朋唤友，现在都是在家做着吃，能省则省。大家对预期普遍悲观，宁愿把钱存银行也不愿意消费，造成大部分传统行业非常低迷，恶性循环。这几年最惨的是中产。消费不振，经济就很难起来。;7;17;24;10006;0.0023985608634819106
论熊市和牛市熊牛出现的方式是交替性的，最大的区别在于时间周期后疫情时代是经济的复苏阶段，能肯定的是比疫情阶段好太多所以，这个阶段可以说经济的底部，需要花时间慢慢的起来因为高通胀供需失衡的阶段也将过去，炒作衰退也好，炒作通缩也好放大了看，都是为了平衡高通阶段的量能使供需回归大周期的平衡所以，个人觉得商品，会上去，但是时候没有到这个阶段情绪行情，风头过后会是一片狼藉;0;4;4;10006;0.0003997601439136518
央行释放加强逆周期调节信号降息预期已拉满央行释放加强逆周期调节信号降息预期已拉满时隔近一年，央行天期逆回购利率由降至，释放出货币政策加强逆周期调节的信号。年月日，中国人民银行开展了亿元的天期逆回购操作，中标利率下降个基点（）至。这一具有风向标意义的利率是自年月以来首次调整。对冲当日到期的亿元天期逆回购后，整体零投放。不到一周前，央行行长易纲在上海调研时表示，当前中国经济还处于疫情冲击后的恢复阶段，市场主体资产负债表正在修复；在货币政策上，央行将在继续精准有力、保持稳健的同时，加强逆周期调节，全力支持实体经济，促进充分就业，综合运用多种货币政策工具，保持流动性合理充裕，保持货币信贷总量适度、节奏平稳，推动实体经济综合融资成本稳中有降，保持人民币汇率在合理均衡水平上基本稳定。;4;14;18;10006;0.001798920647611433
收盘点评：市场是有利好消息的而且是大消息只不过你们没看出来罢了就是这条中国央行：今日进行亿元天期逆回购操作，中标利率为，此前为一般来说这是降息的前奏信号这就是我周评里面写的后面你们玩的是分母端了也就是利率下行今天的十年期国债已经跌破直破年月的疫情底也就是眼前的事情了所以你觉得时下走强难道是偶然的？是必然的趋势降息往往意味着经济不佳那么中特估那些逻辑就不顺畅了他们认怂了自然市场也就凝聚起共识了看懂了吗？除了比我预期的要早一些（我以为会是月会议后落地）其它早就是明牌了;3;29;32;10006;0.0031980811513092145
重大利好为何对股频频失效？多空决斗已定在周四真是服了在上周五大盘重新站上日线之后，上方的日线泰山压顶。由于日线和日线的夹角无限接近，所以老苏分析认为，大盘将在本周初做出方向性选择。然而让人没想到的是，大盘居然能在这么狭小的区间内震荡两个交易日，每天的振幅都还控制在个点左右。这种走势，在过去很长一段时间内都没有出现过。尤其值得注意的是，本周消息面上的大事还不少，利好利空都有，比如周末大家非常担忧的大块头问题、央行行长的维稳发言等等。今天，央行央行为维护银行体系流动性合理充裕，以利率招标方式开展了亿元逆回购操作，中标利率为，此前为。此举，可以看成是央行在变相降息，在消息公布之后，国债期货市场开启狂飙模式。不过对于股市来说，造成的影响就相对复杂一些。通常情况下，降息都是重量级的利好。但市场对逆回购利率下调的敏感度并不是太高，更多的注意力还是集中在本周四的利率和日的利率是否下调上。与此同时，利差的扩大也在汇率市场造成了负面影响。今天人民币汇率在此影响下大幅波动，离岸人民币兑美元杀跌点，并跌破大关。而汇率走弱，对股市来说，是利空无疑。回到盘面上来，大家可以发现，大盘在周一没有对过量做出负面反馈，也没有对央行维稳做出正面反馈；今天同样如此，既没有对变相降息做出正面反馈，也没有对汇率贬值做出负面反馈。在老苏看来，出现这种消息面被市场淡化的情况，表明多空双方在目前位置达成了某种默契，还没有到需要拔刀相见的时候但这并不是说，大盘在横盘一段时间后不会选择方向，其实只是差一个契机而已那么这个契机又是什么呢？在上文中，老苏提到了本周四，央行是否会调整利率和日的利率，这相对于逆回购利率来说，更受市场重视。除此之外，本周四统计局还将披露：月工业增加值、固定资产投资、社会消费品零售总额等重磅经济数据而这，恐怕就是打破市场平静局面的关键所在月底，统计局披露了月的第一组重要经济数据。上周五，统计局披露了和。从已经披露的数据来看，制造业连续月处于荣枯线之下，情况不容乐观。处于轴附近，降幅继续扩大，增加了市场对通缩的担忧。可以发现，已披露数据情况并不乐观。因此，本周四的第三组经济数据表现如何，将是整个市场关注的焦点，也能在更大程度上反应我国经济月运行状况的全貌对于股市场短期走势而言，如果月剩下的经济数据表现稳健，则会成为支持大盘向上突破的主要动力；反之，则会拖累大盘破位下行。那么月剩下的这些数据到底会有怎样的表现呢？老苏和大家分享一下某个研究机构的预测结果：工业增加值方面，在高基数效应下，预计月份工业增加值同比增长，较上期回落个百分点。消费方面，受基数效应影响，以及疫情政策改变后整体消费环境便捷的影响，预计月份社会消费品零售总额同比增长，较上期下降个百分点。进出口方面，预计月出口同比增速为，较上期下降个百分点；预计月份进口同比增速为，较上期回升个百分点。如果这家研究机构的预测结果不太离谱，那么情况可想而知，月剩下的经济数据恐怕不会有太好的表现。金融数据这边，也会有类似结果。在旌阳看来，这也是预期之中的事情，毕竟月的绝大多数经济数据，和月的前两组数据都不太乐观，我们又有什么信心认为周四要披露的数据会有出色表现呢？如果一直关注老苏的话，其实在最近几天的文章中，旌阳已有相关分析。按照此前判断，今年月由于高基数影响，经济复苏的步伐会有动摇。但是月之后，一些基础大宗商品的价格开始走强，比如焦煤焦炭、铁矿石、金属铜等等，说明制造业已有企稳迹象。这个线索表明，月的经济数据或是近期的一个洼地，月开始会慢慢好转股市这边，由于月数据疲软，在月数据披露之前大盘持续走弱，不排除月数据落地后仍会对市场造成短期冲击，并拖累大盘继续下行一段。但由于月将见拐点，所以即便大盘在周四向下变盘，杀跌空间也不会太大。当然，如果周四在利空落地后，多头主力直接发起反击，是我们更想看到的事情股票财经;0;129;129;10006;0.01289226464121527
家电和医药板块的下跌主要受制于消费需求的回落和行业竞争的加剧家电行业在疫情期间受到了居家办公、在线教育等新兴需求的刺激，但随着疫情防控形势好转和经济恢复正常，这些需求有所减弱，而且家电产品本身具有较长的更换周期，导致市场饱和度较高并且家电这两天也受到了所谓夏季制冷的炒作噱头和家电下乡的刺激，这个需求量其实被大厂分散后，对于公司业绩提振还是相对有限的医药行业在期间受到了政策扶持和公众关注度的提升，但医药需求有所放缓，而且医药行业本身也面临着创新能力不足、同质化竞争激烈、监管压力增大等问题;1;12;13;10006;0.0012992204677193685
疫情后的经济恢复都很难，现在我这边澳洲商家客户都说日子不好过。今天在朋友圈看到一个本地商家演讲片段，说最近澳洲零售生意达到了年以来的最低点。所以今年各位澳洲老板目标还是先把现金流稳定，不要太激进，不然生存都有可能成问题。;2;5;7;10006;0.0006995802518488907
央行公开市场操作利率下降个基点提振市场信心支持经济回升向好财联社月日电，人民银行今日开展公开市场天期逆回购操作亿元，中标利率为，下降个基点。消息公布后，金融市场信心提振，反应积极。当前，我国经济处于疫情冲击后的恢复阶段，经济增长动能逐步增强，居民消费稳步提升，市场主体活力逐步恢复，中国经济可保持长期持续稳定增长。同时，实体经济从疫情中恢复也需要一个过程。今日央行公开市场天期逆回购操作中标利率下降个基点，既反映了资金市场供求，也释放了加强逆周期调节和稳定市场预期的政策信号，是稳健货币政策精准有力的体现。财联社新闻的微博视频;17;18;35;10006;0.0034979012592444535
疫情解封后的半年时间，很多实体店感觉经济迎来了短暂复苏，但很快又戛然而止，问题到底出在了哪里？各地楼市行情和这种戛然而止有强关联吗？背后的逻辑是否还是对未来经济的担忧。;24;81;105;10006;0.01049370377773336
高考作文预测疫情后的经济复苏要怎么做？;5;8;13;10006;0.0012992204677193685
高考作文押题大赛没人猜疫情结束后的经济复苏、生活愿景吗？;-2;2;0;10006;0.0
曼杜拉海滨城，有许多豪宅游艇，可以说是富人度假生活的天堂。但疫情后的状况，这里的豪宅也空置了许多，有些还在挂牌出售。受经济下行的影响，这里空置及出售的大多数豪宅的主人，其实并非澳洲人，更多的是咱国人，这里面就有了许多故事。真是不便多言了。;-13;2;-11;10006;-0.0010993403957625424
疫情后的香港物价暴涨之夸张，走走看看并没有太大的购物欲，该有的淘宝都有甚至便宜更多，香港经济瘫痪几年，服务行业人员的普通话完全打咩，直接用粤语跟你说好像粤语是国际标准语一样，这一点语言自信跟重庆人很像，我记得我一朋友几年前来日本找我的时候买东西直接跟日本人说重庆话，人家听不懂还一脸疑惑：你啷个回事？你居然听不懂重庆话？虽然但是，香港人摆烂营业的感觉我是还挺喜欢的，这钱可赚可不赚很酷;-8;3;-5;10006;-0.0004997001798920647
此时刚出白云机场，马路上到处都是车，网约车等候的停车场到处都是人。疫情后的经济复苏感觉还是广东最快。;29;137;166;10006;0.01659004597241655
手机销量差是因为卖的贵吗个人感觉主要原因是因为手机现在更加耐用，而且创新幅度没有之前那么大，没有必须换的理由了手里的设备已经很流畅了，为什么还要换个新的呢？影像提升的也不那么大，能凑合再用一年就坚持一年吧另外，感觉疫情后的经济也没之前好，应该都是导致手机销量连续下滑的原因吧;47;84;131;10006;0.013092144713172096
真正的特种兵就是本周的行程还没结束，下周的车票已经安排明白了，疯狂给疫情后的旅游经济复苏贡献力量;1;3;4;10006;0.0003997601439136518
国泰航空致歉国泰航空为港岛经济做出了很大贡献。当初港岛取消入境隔离等措施，不就是热爱自由的国泰航空空少传播链导致的疫情一再迁延，防是防不住了，于是选择开放。开放后的港岛经济更有活力，走在了全国的前列。;7;182;189;10006;0.01888866679992005
拜登称债务上限谈判没达到突破点美国债务违约或冲击美元信用美国总统拜登月日与国会参众两院民主、共和两党领袖就债务上限问题进行磋商，但未取得任何实质性进展。在日本参加七国集团财长会议的耶伦月日警告说，美国一旦违约，将对经济和金融产生“灾难性影响”，威胁到疫情后的经济复苏展开;1;2;3;10006;0.00029982010793523883
拜登称债务上限谈判没达到突破点美国债务违约或冲击美元信用美国总统拜登月日与国会参众两院民主、共和两党领袖就债务上限问题进行磋商，但未取得任何实质性进展。在日本参加七国集团财长会议的耶伦月日警告说，美国一旦违约，将对经济和金融产生“灾难性影响”，威胁到疫情后的经济复苏，引发全球经济下滑。蓝视界第眼视频的微博视频;1;2;3;10006;0.00029982010793523883
日本实际工资连续个月缩水日本厚生劳动省月日发布的每月劳动统计调查（速报，员工人以上的单位）月数据显示，考虑到物价变动因素后的人均工资实际上比上年同期减少。实际工资连续个月减少。由于经济从新冠疫情中复苏等推动，现金工资总额有所增加，但未能跟上物价上涨的步伐，持续缩水。（日经中文网）;-1;3;2;10006;0.0001998800719568259
二十强公布中国内地经济总量最大的个城市全部公布了年一季度经济数据。强城市中，除了长沙之外全部公布了经济数据。这是疫情结束后的第一次“季报”，所以非常引人注目。下面看一下，在特殊的经济恢复期，哪些城市进展比较快，哪些城市遭遇了不适应症。;-4;1;-3;10006;-0.00029982010793523883
千万级别列车专车接送不知道是不是我个人感受，疫情放开后的经济一直很疲软，整个珠三角的联系算是紧密，但是高铁的人数下降厉害，当然也有可能是我选了最早的班车;1;0;1;10006;9.994003597841295e-05
券商小幅走强，本周一直强调的短期逻辑就是基于一季报业绩同比、环比改善，昨晚华西、山西等几份财报再度刺激市场。倾向节后的市场还是围绕一季报的修复，以及看疫情在经历五一假期后的状态，经济复苏逻辑仍能看。;1;33;34;10006;0.0033979612232660403
疫情之后的经济复苏真的好难好难，相信很多人深有体会。这剧自从播出后的经济效应肉眼可见，对经济的复苏是多大的助力不要尬黑，不要无脑正常点好不好马上就要旅游旺季了，你们要是给我搞没了，以后新上的仙侠剧我都一一举报，我不看，大家都别看了长月烬明超话长月烬明向全世界安利白鹿长月烬明拉动旅游经济;-5;2;-3;10006;-0.00029982010793523883
好好疫情后的一次车展被冰淇淋喧哗了。中国车企，应该是可以代替房地产的下一个经济支柱产业，如果中国车企产业链做起来，包括在华外国品牌车在内，会是个巨大的经济能量池结果被带节奏成乱七八糟的。如果宝马车在中外搞双重质量标准对中国市场车偷工减料这是真正的歧视和不尊重。一个冰淇淋，激动成那样八辈子没吃过一样舔着脸去要吃;22;50;72;10006;0.007195682590445732
凤凰连麦西澳代表团将访华冀经济多元化发展中国经济发展外交澳大利亚目前，中澳之间在和平解决贸易争端方面，双方都迈出了重要的一步，同中国发展稳定的关系并增进两国之间的经贸发展，对澳大利亚在疫情后的经济增长会起到重要的作用。凤凰名人馆的微博视频;1;2;3;10006;0.00029982010793523883
又看了一下教师编想起来年气势汹汹死活不填师范，结果年底一个疫情直接寄，三四年后的今天经济如此疲软，二本的师范好过一本，八个岗千来个人报，我当初能去的差一点的师范都能直接进初中这么一个竞争程度还不如去考北大还是要先在外面挣钱再做打算啊。;1;0;1;10006;9.994003597841295e-05
展会疫情后的人潮涌动，希望经济也能提振起来，不然今年要吃土了第五届中国（广东）国际印刷技术展览会;0;1;1;10006;9.994003597841295e-05
在别的城市还在为疫情后的经济谋出路整天开些假大空的会喊口号搞文件一二三的时候淄博出圈了而且抓的是并不阳春白雪甚至有很多敏感的点排烟安全卫生，策划者是一部分力量，更多的是政府的魄力和担当。某些政府开会开会，整天一群人坐那叨叨，大量的时间精力去造一些文字垃圾。什么用呢？;1;0;1;10006;9.994003597841295e-05
财通证券：汽车行业月重卡销量万，同比增长趋势有望持续（看好）股市集中赢财经小迷糊超话股票经济复苏低于预期行业竞争加剧风险宏观经济下行风险。事件据第一商用车网数据年月份我国重卡市场销售约万辆包含出口和新能源环比上涨同比增长。月销量同环比双增长主要系出口强劲、换车需求释放所致去年同期重卡销量为万辆基数不高为今年月份重卡市场的同比增长创造了客观条件出口强劲今年月份重卡出口保持了高速增长预计同比增长成以上部分重卡企业继续加库存换车需求持续释放年受疫情影响换车需求受到抑制。年疫情有所缓和运输市场的信心增加再加上春节后各类经济活动增加因而激活了此前被压抑的换车需求。重卡市场同比增长的趋势有望持续由于去年行业景气度下行重卡销量基数较低随着经济复苏年重卡销量的同比增长趋势有望持续。经济基本面在逐步恢复有望拉动货运需求和重卡销量增长全年来看出口或将成为重卡的全新增长点。因此我们认为年经济逐步复苏带动物流需求提升海外出口持续向好重卡销量有望逐季度好转全年重卡销量有望高增长。风险提示经济复苏低于预期行业竞争加剧风险宏观经济下行风险。;5;12;17;10006;0.0016989806116330202
人口老龄化的经济影响（下）本文来自：经济观察网，作者：孙树强头图来自：视觉中国三、人口老龄化会提高实际利率水平利率是资金的价格，同样受到供求因素的影响。作者在书中得出的另一个关键结论是人口老龄化会提高实际利率水平。乍一思考，人口老龄化似乎和利率没什么直接关系，但得出这个结论的逻辑也很简单，从储蓄和投资的相对力量来看，作者认为老龄化会降低储蓄规模，但投资不会出现同等规模的下降，对资金需求力量的相对增强会提高人口老龄化经济体的实际利率水平。从储蓄来看，老龄化对储蓄的影响较为复杂，例如，随着预期寿命的延长，人们在年轻时期会更多的储蓄，为退休之后做准备；同时，退休的老年人口基本上都是在消费，这部分人群的储蓄水平会越来越少，总体对储蓄的影响要看哪种力量更大。作者在书中提出了另一个角度，指出目前一些国家出现的一个现象是结婚和生育年龄提高，这就导致在孩子成年离开父母到父母的退休之间的时间缩短，父母可以为自己退休之后进行储蓄的时间减少，降低了储蓄规模。但这种推论也存在一定问题，并非必然得出父母储蓄下降，父母在结婚之前开始工作，依然可以正常为退休进行储蓄。而且从孩子来看，虽然离开父母较晚，但孩子参加工作后可以自食其力，并不一定依靠父母供养，也不会降低父母的储蓄水平。从投资来看，作者从发达国家的情况观察，住房需求将保持稳定，老年人会居住在自己的房子里，孩子成立新家庭将创造新的住房需求，需要进行大规模投资。作者还提到了意大利的例子，老年人会希望住得离医院更近一些，提高城市中心医疗设施附近的住房需求。同时，随着劳动力变得更加昂贵，企业部门可能会进行资本投资以提高资本劳动比，进而提升生产率，这将会提高投资、进而提升对资金的需求。作者认为，综合上面两种趋势，储蓄可能出现下降，投资并不必然下降甚至会提高，最终会提高实际利率水平。当然，上述推理只是作者的一个逻辑推演，尤其是老年人居住在自己的房子里，不与孩子一起生活，从而导致住房需求增加，这与文化和习俗有一定关系，具体到各经济体的现实，利率上升也并不是必然出现的结果。例如，如果因为寿命延长、社会保障体系不健全、文化等因素导致人们更多地储蓄，实际利率就有可能出现下降。实际上，沿着作者的思路更进一步可以提出这样的问题，如果利率确实提高了，那么是否反过来对储蓄产生影响呢，提高储蓄规模，从而减弱利率上升的趋势。作者对于这个问题并没有深入探讨。四、利率提高加剧债务问题利率是资金的价格，也是债务的成本。前期，主要经济体的低利率导致杠杆率高企，债务规模庞大，实际利率上升会使债务负担加重，并增加财政困难、施压经济增长，但上面的分析表明，长期人口结构变化很可能会导致利率上升。那么，如何规避债务危机呢？作者认为，通过经济增长来化解债务的机会渺茫，预期外的通胀、债务重组、违约、债务豁免等途径都不是解决债务问题的有效办法，而在现代经济中，解除债务融资几乎不可能，为了规避债务违约产生的不良冲击，面临实际利率上升的经济体要从债权融资转向股权融资。股权融资没有到期日，红利发放的自由度也较大，规避了债务的刚性约束所造成的困境。对于中央银行来说，在实际利率上升的背景下，也会面临较大压力。在低通胀的背景下，中央银行可以维持低利率水平来刺激经济增长，财政部门也希望保持低利率，从而降低债务负担，此时中央银行和财政部门的目标是一致的。但在通胀上升的情况下，央行却不得不提高利率，但提高利率会增加财政部门的债务负担，财政部门和央行的目标不再一致。在此背景下，中央银行的独立性也会陷入危险的境地。同时，政府也不喜欢利率水平太高，因为太高的利率会产生紧缩效应，不利于经济增长，在选举制国家，会对在位政府的下一次选举产生不良影响。作者在书中也提到，在全球金融危机之前的“大缓和”（）时期，通货膨胀水平较低，全球经济增速较高，这也是主要得益于人口红利的帮助，但“大缓和”给央行造成了一种幻象，似乎是货币政策的纵横捭阖实现了低通胀的结果，实际上并非如此。未来，人口老龄化产生的通胀压力必然会对央行造成更大的挑战。五、全球人口变化趋势与不平等作者在书中也讨论了人口趋势对不平等的影响。年期间，很多发达国家不平等程度出现下降，尤其是二战之后的一段时期，经济增长惠及了经济中的大部分人口。但近年来，一些发达国家内部不平等现象突出，引发了民粹主义的潮起，并对全球化产生了负面冲击，最明显的事件就是特朗普的上台及其所实施的一系列政策。作者在书中认为技术变革、垄断力量增强和行业集中度提高、全球化和人口趋势是影响发达国家不平等的主要因素。一些研究表明，技术进步导致对某些类别劳动力的需求下降，使这些类别的劳动力出现失业，直接导致其收入水平下降，也会导致某些群体的竞争更加激励，例如作者提到，在全球定位系统（）出现之前，伦敦的出租车司机要先认真学习地图并通过考试才能上岗，但使得熟悉城市道路不再是问题，任何持有驾照的人都可以选择当优步司机，出租车行业的竞争也就更加激烈，收入水平也就无法快速提高。垄断力量增强和行业集中度对不平等的影响主要体现在厂商在劳动力市场上形成买方垄断，雇主相对于雇员力量更强大，雇员谈判和议价能力低。对于人口对不平等的影响，作者也认同这样一种观点，即移民或产业向发达国家的国外转移，削弱了国内劳动力的议价能力，进而导致工资水平下降。这是一种直观的推理，但这种力量到底多大需要深入探究，作者也承认，他们也可能是错的。六、菲利普斯曲线形态的变化菲利普斯曲线描述了通货膨胀和失业率之间的关系，一般来说，短期内失业率越低，通胀水平越高，菲利普斯曲线在失业与通货膨胀的二象限图形内是一条左上右下倾斜的曲线。但在长期，经人们的预期调整之后，通货膨胀与失业率之间并不存在负相关关系，菲利普斯曲线是垂直的。短期内，菲利普斯曲线的形态决定了通货膨胀与失业之间的相关性。年全球金融危机之后，一些发达国家尽管实施了大幅宽松的货币政策，失业率也逐渐降至非常低的水平，但通货膨胀就是没有起色，迟迟达不到一些经济体央行设定的通胀目标。当时无论是在学术界还是政策部门，都在讨论菲利普斯曲线的形态变化以及菲利普斯曲线是否还有效。作者在书中提出，有大量的老年人在工作和不工作之间进退徘徊，劳动力供给弹性变大，这就会使工资水平不会快速提高，导致菲利普斯曲线变得更加平坦，通货膨胀与失业之间的相关性降低。同时，老年劳动力蓄水池的存在意味着自然失业率也就更低。自然失业率是由诺贝尔经济学奖得主米尔顿弗里德曼提出的一个概念，是指劳动力市场和商品市场在非外力刺激下处于均衡状态的失业率，也称为非加速通货膨胀的失业率（，），在存在老年人口劳动力的情况下，经济可以在失业率非常低的水平下运行，而不至于引起通货膨胀快速上升。新冠疫情改变了主要发达国家的通货膨胀形势，由于疫情对供应链的扰动，通货膨胀水平大幅上升，以美国为首的一些国家通货膨胀水平达到近年来的最高水平，这些经济体的中央银行也不得不快速收紧货币政策来控制通胀。目前，美联储快速提高的利率除了对控制通货膨胀发挥作用外，还对金融体系产生了非常大的负面冲击，以硅谷银行倒闭为开端，金融风险有扩散蔓延之势，目前尚难估计这种负面影响有多大。七、逆主流而行无论是关注短期还是长期，在做经济分析和预测时，重要的是不要遗漏关键变量，否则分析的结果必然与现实不符，甚至是南辕北辙。在书的最后一章，作者分析了他们与主流观点的不一致之处，主要体现在三个方面：一是作者对个人储蓄的变化趋势不如主流观点那样乐观。持久收入假说认为，人会根据长期收入水平来平衡储蓄和消费。但作者认为，老年人口的储蓄会大幅下降，同时年轻人口由于上面提到的原因，储蓄也不会像过去几十年那样大，总体来看，经济中的储蓄规模可能会下降。二是作者对劳动力收缩条件下的企业投资更加乐观。主流观点认为，随着劳动力收缩，企业投资会下降。但作者认为，一方面，在劳动力收缩的背景下，企业为了提高生产效率，将会提高资本投资；另一方面，全球化受阻后，一些国家将会推动部分产业回流，这也将提高企业投资水平。实际上，投资上升还是下降，还是要取决于最终需求，脱离需求讨论投资必然得不出明确的结果。三是主流观点认为人口和债务都将压低未来的增长、利率和通胀。但作者却认为人口将与债务发挥不一样的作用，人口老龄化将提高通货膨胀和利率。主流观点不认为财政和货币政策关系将出现很大变化，因为这对于低利率和低通胀的预测意味着债务再融资和赤字积累几乎不会引发财政和货币政策之间的冲突。但因为人口老龄化可能会提高通货膨胀和利率水平，作者认为二者的目标将出现冲突。人是经济社会中最重要的因素，是经济发展的决定性变量，是社会前进的最重要推动力量。人口结构会随着经济发展而变化。目前全球的一个普遍现象是，随着经济发展水平的提高，人口老龄化程度会逐渐加深。毫无疑问，人口老龄化是很多经济体面临的一个迫在眉睫的难解之题。难就难在人口生育率下降、老龄化提升的惯性太强，政策发挥作用的空间不大，人口结构转型也必然会带来一系列值得关注和待解的问题。查尔斯古德哈特和马诺吉普拉丹在《人口大逆转》一书中提出了他们关于人口结构变化对通胀和实际利率的理解，算是一家之言，一个逻辑推演，能否出现书中预测的结果，还要看各经济体的实际情况，难以一概而论。但作者的讨论具有启发意义，值得我们深入思考。尤其是我国也面临着越来越严重的人口老龄化问题，将会对我国经济社会产生一系列重要影响，要求我们下好先手棋、打好主动仗，做好提前应对。;1;4;5;10006;0.0004997001798920647
月日，原日本大分市市长佐藤树一郎先生当选第届大分县知事（相当于中国的省长），并将于月日正式就任。佐藤先生早年作为日本经济产业省出身的外交官，曾担任过日本驻旧金山总领事馆领事，日本贸易振兴机构纽约事务所所长等要职。年当选日本大分市长后，他十分重视与武汉的友好关系，并于展开;2;19;21;10006;0.002098740755546672
全国两会中国经济月好刊推荐聚焦经济复苏，多角度寻找中国答案月，中国外文局各刊围绕中国经济发展进行全方位、多语种解读。此外，还聚焦全国两会，做好民营经济、中国式现代化等热点话题深度报道。其中大型专题报道《民营经济：奋进正当时》，多维度向读者展示民营企业如何拉动展开;1;0;1;10006;9.994003597841295e-05
去有风的地方电视剧超话电视剧梦华录超话支持《去有风的地方》和《梦华录》这两部现象级大爆剧入围白玉兰奖这两部剧不仅制作精良、全体演员演技都在线，而且在传播中国文化、促进旅游经济疫情后复苏起到了很好的推动作用必须要为用心创作国剧精品的这两部剧的展开;12;44;56;10006;0.0055966420147911256
夜经济乡村振兴地摊经济市场经济消费经济发展夜经济，提振市场信心。“小地摊”蕴含“大民生”。点亮“夜经济”，成为不少城市消费提档升级的发力点。夜间经济已经成为现代城市经济的重要组成部分，更是衡量一座城市经济繁荣程度的“晴雨表”。夜经济不能只局限在商业体上，不同区域具有旅游、娱乐方面的特点，应根据不同区域的城市功能进行布局，以突出各自的特点，呈现出不同优势不同特色不同功能的夜经济聚集区。夜间经济的价值远不止于“吃喝玩乐”，其更大的意义在于促使城市文化更加活跃，让城市经济更加繁荣。夜经济的蓬勃发展离不开政策导向。大众看夜经济往往是看个热闹，企业做夜经济的动力是看到利益，夜经济进一步发展要靠市场和政府的合力。地摊经济有着启动资金少、管理成本低等优点。后疫情时代，我国经济下行压力依旧沉重，就业市场遭受巨大冲击，国民经济复苏等问题亟待解决。地摊经济是恢复城市经济活力、助力消费和收入增长的重要手段，是城市烟火气的组成部分之一，也是民生经济的生机和韧性。发展地摊经济能够解决不少困难群众的就业问题，更是刺激消费、留住城市烟火气的务实之举。地摊经济要在管理上务求规范，需要各单位统筹协调、明确责任、有序规划、科学引导，努力把商圈周边的地摊经济打造成具有代表性的城市名片。（农文旅产业振兴研究院常务副院长、县域经济发展合作服务中台工作委员会秘书长袁帅）;1;1;2;10006;0.0001998800719568259
王者归来义乌酒店全部爆满订单排到几个月后义乌作为全球小商品货源地，经历了年的发展迭代。疫情之后，义乌市场作为全球经济复苏的货源大后方，将持续推进“市井经济”的繁荣。义乌小商品城市场经理应文碧告诉潮新闻记者：“自疫情拐点后，特别是开年以来，义乌市场贸易稳中向好，繁荣复展开;1;0;1;10006;9.994003597841295e-05
王者归来义乌酒店全部爆满订单排到几个月后义乌作为全球小商品货源地，经历了年的发展迭代。疫情之后，义乌市场作为全球经济复苏的货源大后方，将持续推进“市井经济”的繁荣。义乌小商品城市场经理应文碧告诉潮新闻记者：“自疫情拐点后，特别是开年以来，义乌市场贸易稳中向好，繁荣复苏态势很明显，过去的个月，客流和订单已经达到疫情前的水平，就比如：我们商城集团旗下在义乌的大酒店，入住率都高达，订房都要提前量。进小商品城各大市场停车，明显也要排一会儿队了。”（潮新闻记者张云山柳蓬）钱江晚报的微博视频;4;16;20;10006;0.001998800719568259
