文本;真实一级评论数;真实点赞数;边数;最大边数;集群密度
日本青森县政府宣布，采购县产扇贝提供给中小学供餐。青森县介绍，学校供餐将动用日本政府因福岛核污水排放设立的“应对形象受损”基金，预计向小学生和初中生约万人供应。青森县计划扩大面向台湾和泰国等地的海外销路，还要求县内外的超市和卖场扩大销售。评一句：蛤蟆结果是跟鬼子学的黄媒不会说的真相;12;76;88;9387;0.009374667092787899
事情是这样的明天要考试啦，所以我去文具店买了只中性笔，一把尺子，一块橡皮，结账的时候老板说，我惊了，就这么点东西？然后我就问了每个文具的价格，其中一支笔元，我再次惊了，一支笔这么贵了？而且也不是晨光爱好什么的，我就向老板提出了质疑老板说“看清楚了，这是斑马”我“啥？斑马？没听过”但我还是付了钱，出门后我在淘宝搜了下，竟然是日本品牌一下子无语到了，我又对了笔上的文字，确定是日本品牌，然后我就毫不犹豫返回店里退了这只笔，换了两只晨光文具真的很生气日本不顾一切往海里排放核污水这件事我永远不会原谅虽然我人微言轻，但是如果每个人微言轻的个体从拒绝一支日产笔做起，那么我相信终有一日星星之火可以燎原日本核污水排海侵犯人权核污水首轮排海结束日本现状如何日本核污水排海侵犯人权抵制日货勿伤同胞坚决抵制日本排放核污水日本计划明年月底前排放轮核污染水坚决抵制日本排放核污水;1;1;2;9387;0.0002130606157451795
日本核污水首次排海造成了哪些影响日本计划明年月底前排放轮核污染水下月启动第二轮核污染水排海，日本计划明年月底前排放约吨核污染水入海。日本核污水排海有哪些连锁反应山西共青团的微博视频;-1;0;-1;9387;-0.00010653030787258975
日本核污水排海有哪些连锁反应皮皮虾变异了？都到渤海湾了？假的日本核污水首次排海造成了哪些影响自从日本正式将核污染水排入海洋以来，各种谣言不断流传。近日，社交媒体上流传着一段视频，视频中一只皮皮虾的表面布满了密密麻麻的大疙瘩。一名男子拿起皮皮虾说道：“这是我们当地的皮皮虾，变异了，现在已经出现在渤海湾了”。经过鉴定，视频中的皮皮虾表面生长的是藤壶，这是一种节肢动物，在海洋中很常见，通常寄生在鲸鱼和海龟身上，部分也会附着在虾蟹身上。因此，并不存在皮皮虾变异的说法。最近，由于日本排放核污染水入海，海鲜等食品安全问题引起了广泛关注。对于这些问题，我们应该保持警惕，但也不必过于担忧。通过正规渠道购买的海鲜，基本上都符合国家检测标准，可以放心食用。百姓求真的微博视频;4;4;8;9387;0.000852242462980718
日本核污水排海有哪些连锁反应日本福岛核污水首轮排海结束，当地现状如何日本核污水首次排海造成了哪些影响据澎湃新闻，当地时间月日正午，日本福岛第一核电站核污染水首轮排海作业结束，总计向太平洋排出吨核污水。根据东京电力公司的计划，接下来将进行设备检查，最早将于月底开始第二轮排海，今年将分次排放万吨核污水。对于日本国内尤其是福岛当地来说，水产品的安全、销路和声誉现今如何？日本福岛核污水首轮排海结束，当地现状如何;5;22;27;9387;0.0028763183125599234
日本核污水首次排海造成了哪些影响日本核污水排海有哪些连锁反应英国小哥谴责日本排放核污水以及西方媒体集体失声，小哥：排海里就安全自己用不安全？中国网直播的微博视频;1;7;8;9387;0.000852242462980718
日本核污水排海有哪些连锁反应日民众游行抗议核污水排海日本核污水首次排海造成了哪些影响月日，日本数百名民众走上东京街头，抗议福岛第一核电站向太平洋排放核污染水。今日俄罗斯的微博视频;1;2;3;9387;0.00031959092361776926
日本核污水排海有哪些连锁反应新浪新闻头号大事件栏目第期：自月日日本核污水排海以来，已经过去了天，核污水的排放引起了国际社会的广泛关注。对于日本国内尤其是福岛当地来说，水产品的安全、销路和声誉现今如何？核污水入海已成事实，各国又采取了哪些措施？戳视频，来看展开;7;92;99;9387;0.010546500479386385
日本核污水排海有哪些连锁反应新浪新闻头号大事件栏目第期：自月日日本核污水排海以来，已经过去了天，核污水的排放引起了国际社会的广泛关注。对于日本国内尤其是福岛当地来说，水产品的安全、销路和声誉现今如何？核污水入海已成事实，各国又采取了哪些措施？戳视频，来看日本核污水首次排海造成了哪些影响。新浪新闻的微博视频;-1;92;91;9387;0.009694258016405667
日本核污水首次排海造成了哪些影响月日，日本首相岸田文雄在首相官邸举办午餐会，试吃了核污染水排放地福岛县沿海捕获的海鲜。月日，日本前环境大臣、前首相小泉纯一郎之子小泉进次郎推出“新招”，在福岛县海岸冲浪，以展示“排海安全性”。如何看待日本首相和政客的这些行为？日本核污水排海有哪些连锁反应新浪新闻的微博投票;19;1753;1772;9387;0.18877170555022904
日本核污水排海有哪些连锁反应女生回应英国街头科普日本核污水排海：“要做点有意义的事情”日本核污水首次排海造成了哪些影响近日，一中国留学生在英国街头科普日本核污染水排海危害，呼吁大家共同传递真相。女生表示，英国的民众以为这就是普通的水污染，自己要做点有意义的事情，让大家了展开;1;77;78;9387;0.008309364014062001
中国大使谴责日本核污水排海侵犯人权当地时间月日，中国代表陈旭大使在发言中指出，日本政府单方面强行启动福岛核污染水排海，严重侵犯太平洋沿岸国家乃至全球人民的健康权、发展权和环境权。其正当性、合法性、安全性一直受到国际社会质疑，并遭到日本、韩国等国民众强烈反对。中方呼吁人权理事会对这一问题加大关注，敦促日方立即停止排海行为。月日，为“反对日本核污水排海、谴责尹锡悦政府”，韩国最大在野党共同民主党党代表李在明已绝食抗议天，弓背垂头体力不支躺卧。日本核污染水第一轮共排放立方米网页链接七环视频的微博视频;1;6;7;9387;0.0007457121551081282
一定是日本排放核污水导致水分过多，引发附近连续暴雨这可是广东的秋天啊，不可能有雨的;1;0;1;9387;0.00010653030787258975
日本今年度计划排超万吨核污水日律师批核污水排海违反国际法日本福岛核污染水将在月底之前启动第二次排海，日本有反对派律师指出，福岛核污水排海违反联合国海洋法公约，第条第项指，禁止将陆地上的有害物质排放入海。日本计划在年月之前，共排放吨核污染水入海，排放的核幅射展开;54;443;497;9387;0.0529455630126771
灵灵看世界：韩国两大在野党向日本核污水排海说不年月日，韩国民主党和韩国正义党两大在野党出发前往欧美等国家，呼吁国际社会共同制止日本核污水的排放计划。此前，在月日，韩国两大在野党召开联合记者会称，他们将向世界人民举报日本政府和东京电力公司核污水排海、污染海洋的展开;5;159;164;9387;0.017470970491104718
上海辟谣豫园商圈只卖进口冰淇淋并不是，人家自己家里有光明冰淇淋，出门想买光明以外的牌子，碰巧看到几个日本牌子或日本原料产的冰淇淋。抵制日货的本意是好的。即使是博眼球流量，也比什么都不做要好。核污水的排放及危害就在眼前，每个人都要力所能及地投入到抗日的力量中。没必要去嘲讽她，除了展开;3;1;4;9387;0.000426121231490359
日本排放核污水不买一分日货超话不买日货，从我做起;1;0;1;9387;0.00010653030787258975
燃日报为抗议日本排放核污水，韩国官员绝食已天，出现体温过低等症状月日，为抗议日本排放核污水，韩国最大在野党共同民主党党代表李在明绝食已经第天，他已出现体温过低、头晕无力等身体机能下降的症状。共同民主党最高委员、国会议员朴赞大表示，李在明没有任何结束绝食抗议的展开;3;6;9;9387;0.0009587727708533077
焦点坊谈超话生死边缘因要求尹锡悦政府道歉并反对核污水而绝食第天，李在明奄奄一息，医疗团队发出绝望警告你还在质疑他在作秀吗？甚至还有人嘲笑他愚蠢不要嘲笑一个为真理较真的人，因为他在争光日本核废水排海第一阶段已经完成，而多吨核废水无声无息排到大海里。日本人就连展开;52;323;375;9387;0.039948865452221156
不的我们早就不在乎了，出道四年天天的，现在正规三恰逢日本排放核污水，所以我们选择的合作曲主要是为了表达对日本排放核污水的赞同的态度而已日本已排放超吨核污染水;1;74;75;9387;0.00798977309044423
宁艺卓得知日本排放核污水暴打吉赛尔为国报仇炸裂到底是谁;1;1;2;9387;0.0002130606157451795
曦婷的视频为什么全世界都无法阻止日本排放核污水？看完就知道了。日本乃知小礼而无大义，拘小节而无大德坚决抵制日本排放核污水;1;0;1;9387;0.00010653030787258975
又是海边捡垃圾的一天那些口诛笔伐日本排放核污水的人可能和向海洋里扔垃圾的是同一批人;2;5;7;9387;0.0007457121551081282
侵犯人权中国大使在人权理事会谴责日本向海洋排放核污染水中国大使谴责日本核污水排海侵犯人权据央视新闻报道，中国常驻联合国日内瓦办事处和瑞士其他国际组织代表陈旭大使日在联合国人权理事会与享有安全饮用水和卫生设施人权问题特别报告员互动对话时发言，指出日本政府单方面强行启动福岛展开;9;196;205;9387;0.0218387131138809
焦点坊谈超话李在明绝食示威进入第天，执政党首次要求其停止月日，韩国民主党党代表李在明为反对日本核污水排海，抗议尹锡悦政府，绝食进入第天。李在明要求尹锡悦政府答应以下三个条件才会进食：向国民道歉反对日本排放核污染水彻底改组内阁此事件最终如何收场呢？感觉展开;88;1096;1184;9387;0.12613188452114626
這個舉動非常很好，那是極好的，就是這樣就給小日子的人自己消耗就行了（別叫我梁伯，這是自食其果。）日本扇貝滯銷改為給中小學加餐？日本強行排放福島核污水後，中國內地停止進口日本水產品，日本扇貝出口受影響滯銷，價格跌幅達三成。青森縣政府日宣佈，採購縣產扇貝提供給中小學供餐。青森縣介紹，學校供餐將動用日本政府因福島核污水排放設立的應對形象受損基金，預計向小學生和初中生約萬人供應。青森縣計劃擴大面向台灣和泰國等地的海外銷路，還要求縣內外的超市和賣場擴大銷售。位於本州最北端的青森縣，養殖扇貝漁獲量為日本第一。日本貿易振興機構（）青森事務所表示，年青森縣產扇貝出口額約為億日元（約億港元），其中對中國出口占。來源大公國際;14;107;121;9387;0.01289016725258336
日本又有放射性物质泄露第一次如此赞同一句话：干不了就别干了怎么这种事儿，还能来好几次的啊，就算这次没危险，下次呢？已经不相信不会有下次这种话了。日本核泄漏日本排放核污水笑女士寄浪漫于笑女士的微博视频;1;7;8;9387;0.000852242462980718
日本大使馆又开始了，不同意中国称核电站排放入海的水为核污水;68;1025;1093;9387;0.1164376265047406
核污水如果安全就没必要排海中方谴责日本核污水排海侵犯人权月日，中方代表在联合国人权理事会上发言，谴责日本排放核污染水入海的行为，指其正当性、合法性、安全性一直受到国际社会质疑，并遭到日本、韩国等国民众强烈反对。中国常驻联合国日内瓦办事处和瑞士其他国际组织代表陈旭指出，展开;16;204;220;9387;0.023436667731969747
中国大使谴责日本核污水排海侵犯人权中国大使在人权理事会谴责日本向海洋排放核污染水侵犯人权中国常驻联合国日内瓦办事处和瑞士其他国际组织代表陈旭大使日在联合国人权理事会与享有安全饮用水和卫生设施人权问题特别报告员互动对话时发言，指出日本政府单方面强行启动福岛核污染水排海，严重侵犯太平洋沿岸国家乃至全球人民的健康权、发展权和环境权。其正当性、合法性、安全性一直受到国际社会质疑，并遭到日本、韩国等国民众强烈反对。陈旭指出，如果福岛核污染水是安全的，就没有必要排海；如果不安全，就更不应该排海。中方呼吁人权理事会对这一问题加大关注，敦促日方立即停止排海行为。日本核污染水第一轮共排放立方米（央视新闻）;1;1;2;9387;0.0002130606157451795
坚决抵制日本排放核污水日本为非作恶居然还倒打一耙日本把“倒打一耙”“恶人先告状”演绎得淋漓尽致。中方发布的地图将钓鱼岛等地标为中国领土，日方对此提出所谓的抗议，中方自然不会接受，因为钓鱼岛就是中国固有领土，历史经纬很清楚。日本将核污染水强行排海后，中方全面暂停日本水产品展开;-2;7;5;9387;0.0005326515393629487
岸田狗熊政府说只有中国在反对核污水排放到海洋，可是日本民众的抗议示威从来就没有停止过，岸田狗熊必须花最大的力气平息日本民众的抗议示威行动;1;0;1;9387;0.00010653030787258975
焦点坊谈超话月日韩国反对日本核污水排海李在明绝食第天。昨天他已经弓背垂头体力不支侧卧今天多么渴望他能够出来给大家比个心啊日本计划明年月底前排放轮核污染水李在明已绝食抗议天椒哥微记录的微博视频;3;94;97;9387;0.010333439863641205
缺德必遭天谴日本日本排放核污水珍爱海洋守护蔚蓝甜乃奈的微博视频;1;2;3;9387;0.00031959092361776926
抗日小饼干大早上看到大家为小饼干打得不可开交在开口吵架之前，静下心来先看看真相不才是最重要的么如果真的想支持抗日，就去关注日本排放核污水的事吧，当代抗日最直接的行动;1;3;4;9387;0.000426121231490359
中国大使谴责日本核污水排海侵犯人权中国大使在人权理事会谴责日本向海洋排放核污染水侵犯人权中国常驻联合国日内瓦办事处和瑞士其他国际组织代表陈旭大使日在联合国人权理事会与享有安全饮用水和卫生设施人权问题特别报告员互动对话时发言，指出日本政府单方面强行启动福岛核污染水排海，严重侵犯太平洋沿岸国家乃至全球人民的健康权、发展权和环境权。其正当性、合法性、安全性一直受到国际社会质疑，并遭到日本、韩国等国民众强烈反对。陈旭指出，如果福岛核污染水是安全的，就没有必要排海；如果不安全，就更不应该排海。中方呼吁人权理事会对这一问题加大关注，敦促日方立即停止排海行为。（央视新闻）;1;5;6;9387;0.0006391818472355385
坚决抵制日本排放核污水月日是日本核污水排海第二十二天，第一批核污水结束排海第天。日本内阁改组完成，但没有传出停止排海的消息。据媒体报道（叠甲太厉害，简称媒体），东电排海计划，到明年月底，将再排放三轮核污水，总共排放四批。里面有句话真的让人气愤，东电预测四轮核污水排放里氚的总量比全年氚排放量上限低，一个万亿贝克勒尔，一个万亿贝壳勒尔。严格来说这里可以反复鞭打东电了。核污水其他放射性物质的排放量被谁吞了一个核电站半年的氚排放量，跟全球全年比实际排放量跟理论数据能完全一致？（还有全年氚排放量这个词，媒体新闻也没有详细说法，谁知道是个什么样的定义词。）部分曾住在福岛的日本民众在年月，向东京地方法院提起集体诉讼，以“受到福岛第一核电站事故带来的放射性物质影响而患甲状腺癌”为由，向东京电力公司索赔。日，东京地方发院再次开庭审理此案。日下午，上百名民众在东京地方法院前集会要求东电和日本政府承担责任，向原告进行赔偿。之前在站看福岛核电站核泄漏的影响，就有讲到有民众因核辐射而患癌，他们的维权路走得艰难。日被发现有放射性物质泄露的原子能研究机构，之前也发生过核泄漏意外事故，有员工吸入放射性粉末，导致遭受严重核辐射影响。频频犯错，人们会怀疑而失去对事物的信任，日本原子能机构屡犯不鲜。尽管东电被官司缠身，被民众集会抗议，民众对核安全问题的担忧和顾虑尚未处理和解决，日本核电重启依然提上日程。日，日本关西电力公司称高滨核电站号机（位于福井县高滨町），将于当地时间日时左右重启。好家伙，百科词条显示高滨核电站出现过泄露事故，还发生过火灾，停运重启停运反复。以后会有由于质量问题而发生的事故吗？岸田政府铁了心一边转嫁核污染一边发展核电，国内渔业怎么办岸田表示继续要求中国撤销水产品禁令。转移民众关注焦点，发展核电是为了复兴，中国竟然禁进，赤裸裸的经济封锁，欺人太甚。（以上为对日本舆论战的意淫）对韩娱、韩国偷文化、韩国大男子主义，女性地位极低等等韩国社会现状没有好感，所以很少关注韩国。尹锡悦政权支持日本排海一事引起我的对这个人（还有代表政权）的注意。韩国政府向第届联合国人权理事会提交一份韩国历史问题相关意见书，“政府已经解决或正在解决大部分历史遗留问题”，“日本政府向慰安妇受害者和被掳劳工受害者正式道歉，并承认了加害事实”，“在被朝绑架后归国的渔夫被扣上间谍罪名的事件中，由于实施绑架的是朝方，因此无法确定责任人。”这些炸裂内容出现在原文中，尽管韩国内部猛烈抨击以上言论，但我作为旁观者对此太阳表示瞠目结舌。一个政府如何能枉顾历史、枉顾事实，违背自己的祖宗，违背人民的意志，无视民族情感，无视民族曾经遭受过的耻辱，为敌人洗地一个政府这样做不是选择站在了人民的对立面精神日本人倘若描述个人，那这个政府是否为“舔”为“屈膝”为“奴”所以，这样的政府还会在核污水排海这件事情上对民众有什么积极回应吗，现实的民声还不平息，就撬动大众历史的神经，令人费解。而李在明的绝食抗议，有多少概率唤醒一点政府日，据港媒报道，香港首次发现来自受管制县份的蔬菜。保持警惕，不能让有核辐射风险的食品流入中国。最近大陆社会由于一品牌形象“崩塌”，大量国货相继爆火，今天一款“抗日小饼干”进入大众视野（更多人知道了）。嘉顿公司，曾在抗日时期连续日生产共万公斤抗日劳军饼。抗日饼干，名副其实。（图片源于网络）反对日本排放未处理核污水超话我们强烈反对日本核污染水排海日本计划明年月底前排放轮核污染水日本甲状腺癌患者状告东电日研究机构发生放射性物质泄漏日本高滨核电站号机组明天将重启李在明要绝食到体力不支昏倒为止禁止来自日本个都县的食品的进口;1;0;1;9387;0.00010653030787258975
日本年度预计排放核污水超万吨日本核污水没有毒就不用排海，如果有毒就更不应该排海日本政府正式决定福岛核废水排海小日本绩点德吧那些海洋生物怎么办，抵制小日本，无论只以前侵华实验室，还是现在的向大海排核污水，小日本都罪孽深重日本将用亿日元处理核污染水负面信息;1;1982;1983;9387;0.21124960051134548
日本福岛当地居民状告东京电力公司，核辐射造成多人患甲状腺癌核辐射，核污水，那个都是致命的污染环境元凶？日本不顾民众民意肆意妄为的排泄核污水入海，最先受到伤害的就是他们自己民众近日，福岛当地居民组织大量群众上街游行，反对核污水排放入海的行径，目前因福岛核电站辐射污染造成当地人患甲状腺癌症经过相关机构的检测报告，患甲状腺癌患者病例指数均与核辐射污染有关当地居民已经将东京电力公司告上法庭，要求赔偿历史会记住日本政府这一笔日本核污染水排海正式开始日本水产行业哀鸿遍野核污水排海最严重影响是致畸谁在炒作只有中国反对日本排放核污水;1;51;52;9387;0.005539576009374667
李在明要绝食到体力不支昏倒为止李在明绝食第天，已现体温过低等症状，李在明绝食抗议暂无停止计划月日，为抗议日本排放核污水，韩国最大在野党共同民主党党代表李在明绝食已经第天，他已出现体温过低、头晕无力等身体机能下降的症状。共同民主党最高委员、国会议员朴赞大接受凤凰记者独家采访时表示，李在明没有任何结束绝食抗议的计划，因为他要通过实际行动体现国民反抗日本核污水排放的坚定意志，直到体力不支昏倒为止，直到执政党回应从而听取韩国国民的意见为止。凤凰卫视凤凰卫视的微博视频;31;126;157;9387;0.01672525833599659
日本排放核污水日记第二十二天。;1;5;6;9387;0.0006391818472355385
日本偶遇逛街排放核污水的日本;1;0;1;9387;0.00010653030787258975
啊啊啊啊那其实全球的东西都不能买了，小姐姐下次只买中国制造欢欢喜丸子回复对，我搞错了，属于日本企业，不是日本产地。核污染这个事情，其实核污水已经排放了，哪里生产不重要了，全球都会被污染，我是不想买日本品牌，买不买还是看个人意愿吧欢欢喜丸子是日产;1;3;4;9387;0.000426121231490359
宁艺卓得知日本排放核污水暴打吉赛尔为国报仇啊？;2;0;2;9387;0.0002130606157451795
外国人如何看待日本排放核污水？没想到会是这个反应研究称日本核污水排海天到达中国日本核污染水排海正式开始熊哥哥爱健身的微博视频;9;43;52;9387;0.005539576009374667
不能忘不敢忘日本部队罪大恶极勿忘历史吾辈自强日本罪行日本排放核污水快手快手主持嘉文的快手视频;1;0;1;9387;0.00010653030787258975
李在明要绝食到体力不支昏倒为止李在明绝食第天，已现体温过低等症状，李在明绝食抗议无停止计划月日，为抗议日本排放核污水，韩国最大在野党共同民主党党代表李在明绝食已经第天，他已出现体温过低、头晕无力等身体机能下降的症状。共同民主党最高委员、国会议员朴赞大接受凤凰记者独家采访时表示，李在明没有任何结束绝食抗议的计划，因为他要通过实际行动体现国民反抗日本核污水排放的坚定意志，直到体力不支昏倒为止，直到执政党回应从而听取韩国国民的意见为止。李在明已绝食抗议天凤凰卫视凤凰卫视的微博视频;19;22;41;9387;0.0043677426227761796
治疗癌症只能是西医集团，如果有个人医疗机构能治疗癌症，一定要搞死。青岛中医案就是典型日本反对他国直接取样独立检测太平洋沿岸国有权向日本政府发起核污水索赔日本计划明年月底前排放轮核污染水日本将用亿日元处理核污染水负面信息;-4;66;62;9387;0.006604879088100564
李在明要绝食到体力不支昏倒为止他说要通过这种行动，来体现韩国国民反抗日本核污水排放的坚定意志。可惜那些人只会装作看不见，后面还是换种方式再继续抵制吧。;29;161;190;9387;0.020240758495792054
李在明绝食抗议无停止计划李在明绝食第天，已现体温过低等症状，绝食抗议无停止计划月日，为抗议日本排放核污水，韩国最大在野党共同民主党党代表李在明绝食已经第天，他已出现体温过低、头晕无力等身体机能下降的症状。共同民主党最高委员、国会议员朴赞大接受凤凰记者独家采访时表示，李在明没有任何结束绝食抗议的计划，因为他要通过实际行动体现国民反抗日本核污水排放的坚定意志，直到体力不支昏倒为止，直到执政党回应从而听取韩国国民的意见为止。（凤凰卫视）李在明已绝食抗议天凤凰卫视的微博视频;8;59;67;9387;0.007137530627463513
感谢郑老板亲自操刀的“领证宴”说本来想等我俩领证了整一顿但因为日本排放核污水这不得不提前了也不管我俩领不领证了先吃为敬;-3;2;-1;9387;-0.00010653030787258975
关于日本核污水排放方法收集，方法写到评论里，也许最后也无人知，但至少我们也提出过。;1;0;1;9387;0.00010653030787258975
焦点坊谈超话绝食第天李在明弓背垂头体力不支躺卧月日，为“反对日本核污水排海、谴责尹锡悦政府”，韩国最大在野党共同民主党党代表李在明已绝食抗议天，弓背垂头体力不支躺卧。此前媒体报道，李在明因体温过低等原因，已经出现身体机能下降的症状，已经开始需要用拐杖支撑才能行走。日本计划明年月底前排放轮核污染水椒哥微记录的微博视频;2;7;9;9387;0.0009587727708533077
韩国政客李在明为抗议日本核污水排放，绝食第天，已现体温过低等症状。李在明已绝食抗议天青年视频说的微博视频;2;18;20;9387;0.002130606157451795
日本排核污水香港食环署首次发现有来自日本受管制县份的蔬菜香港食物环境卫生署食物安全中心昨日检查一批日本进口食品时，首次发现当中有来自受管制县份的蔬菜。日本上月底开始排放核污染水，香港随即禁止来自日本个都县的食品的进口。据悉，涉事产品已被封存，未流出市面，香港食环署食物安全中心正跟进此事件。食物安全中心发言人说，中心检查该批日本进口食品的食物标签时，发现一包来自福岛县的日本青枫叶和一包来自群马县的茄子，并未附有辐射证明书和出口商证明书，违反相关规定。发言人强调，中心会继续跟进事件和采取适当行动，包括就事件通知日本有关当局。如有足够证据，中心会向涉事进口商提出检控。调查仍在进行。;1;11;12;9387;0.001278363694471077
李在明绝食出现体温过低等症状绝食抗议无停止计划据凤凰周刊报道：月日，为抗议日本排放核污水，韩国最大在野党共同民主党党代表李在明绝食已经第天，他已出现体温过低、头晕无力等身体机能下降的症状。共同民主党最高委员、国会议员朴赞大接受凤凰记者独家采访时表示，李在明没有任何结束绝食抗议的计划，因为他要通过实际行动体现国民反抗日本核污水排放的坚定意志，直到体力不支昏倒为止，直到执政党回应从而听取韩国国民的意见为止。李在明已绝食抗议天凤凰卫视的微博视频;26;158;184;9387;0.019601576648556513
日本，你凭什么说核污水是中国排放的，你自己做事不敢承认是吗，你要是觉得你排的核污水没问题，那你为什么不让其他国家进行检测日本反对他国直接取样独立检测地球可以没有日本，但不能没有海洋海洋地球;2;3;5;9387;0.0005326515393629487
李在明要绝食到昏倒为止这恒心啧啧，为了抗议日本排放核污水，韩国最大在野党李在明已经绝食了天，已经出现了体温过低、头晕无力等身体机能下降的症状。但他现在没有任何结束绝食抗议的意思，他要绝食抗议到昏厥为止。;15;247;262;9387;0.027910940662618514
华为浏览器日本福岛县甲状腺癌患者状告东电，民众集会声援评：支持日本人民维护生存权而生存权，又是最基本的人权。日本东电公司的最大股东是美国的贝莱德集团。那么一直打着民主、自由、人权牌坊的美国，就要为高调支持日本排放核污水付出代价。肩负起一个发达大国的责任，做好展开;2;3;5;9387;0.0005326515393629487
华为浏览器日本福岛县甲状腺癌患者状告东电，民众集会声援评：支持日本人民维护生存权而生存权，又是最基本的人权。日本东电公司的最大股东是美国的贝莱德集团。那么一直打着民主、自由、人权牌坊的美国，就要为高调支持日本排放核污水付出代价。肩负起一个发达大国的责任，做好因福岛核电站核污水排放对日本人民造成伤害的相关赔偿工作，消除核污染源等，美国责无旁贷。现在受核污染危害最多的是日本人民，如果继续排放下去，后果不堪设想，美国、日本东电，悬崖勒马的时候到了。转发自新浪微博，侵权即删;2;3;5;9387;0.0005326515393629487
香港查获日本核辐射地区违规进口蔬菜，产品封存无流出市面为应对日本排放核污水计划的《食物安全命令》已于上月生效，香港特区政府表示，一包来自福岛县的日本青枫叶，以及一包无附有辐射证明书及出口商证明书的群马县茄子，被发现违反《命令》，产品现已封存，无流出市面。网页链接根据《命令》，源自福岛县的所有蔬菜均禁止入口，而从日本群马县进口的蔬菜，则须附有辐射证明书及出口商证明书才可进口。食安中心正跟进事件，包括就事件通知日本有关当局。如有足够证据，会向涉事进口商提出检控。;0;7;7;9387;0.0007457121551081282
凤凰独家李在明绝食第天党友无停止计划李在明绝食第天承受时间已达极限李在明绝食只靠水和盐维持生命李在明绝食第天须拐杖支撑行走韩国最大在野党共同民主党党代表李在明，绝食抗议日本排放核污水已经第天，此次李在明绝食抗议也受到社会广泛关注。共同民主党最高委员、国会议员朴赞大接受凤凰卫视独家采访时表示，李在明没有任何结束绝食抗议的计划，因为他要通过实际行动体现国民反抗日本核污水排放的坚定意志，直到直到体力不支昏倒为止。纪同学叫思清凤凰名人馆的微博视频;2;2;4;9387;0.000426121231490359
李在明要绝食到昏倒为止李在明绝食第天，已现体温过低等症状，绝食抗议无停止计划月日，为抗议日本排放核污水，韩国最大在野党共同民主党党代表李在明绝食已经第天，他已出现体温过低、头晕无力等身体机能下降的症状。共同民主党最高委员、国会议员朴赞大接受凤凰记者独家采访时表示，李在明没有任何结束绝食抗议的计划，因为他要通过实际行动体现国民反抗日本核污水排放的坚定意志，直到体力不支昏倒为止，直到执政党回应从而听取韩国国民的意见为止。李在明无限期绝食进展（凤凰卫视纪思清、杜伟安、林逸生首尔报道）凤凰卫视的微博视频;29;320;349;9387;0.03717907744753382
管管自己餐桌的饭菜如何？你点的外卖是怎么做出来的？据说过餐的剩菜都可以产生亚硝酸盐（致癌物质），预制菜几天、几十天、几个月的“预制菜”产生多大量的致癌物质？我国食品污染、环境污染已经相当严重，难怪有人说，再不治理（特别是农药残留）的话，年之后中国人可能生不出来孩子前些时候日本排放核污水，国人反应及时、强烈。但管人家被窝里头拉屎，倒不如先管好自己餐桌上吃的饭菜来得更有实际的意义。不是吗？穆子的微博视频;1;3;4;9387;0.000426121231490359
李在明绝食第天李在明党友：李在明无停止绝食计划为抗议日本排放核污水，韩国最大在野党共同民主党党代表李在明绝食已经第天，他已出现体温过低、头晕无力等身体机能下降的症状。共同民主党最高委员、国会议员朴赞大接受凤凰记者独家采访时表示，李在明没有任何结束绝食抗议的计划，因为他要通过实际行动体现国民反抗日本核污水排放的坚定意志，直到体力不支昏倒为止，直到执政党回应从而听取韩国国民的意见为止。李在明无限期绝食进展（凤凰卫视纪思清、杜伟安、林逸生首尔报道）凤凰卫视的微博视频;40;163;203;9387;0.02162565249813572
近日，核污染水排海的新闻刷爆各软件核污水排海已成事实作为普通人的我们核污水排海会对我们产生什么影响呢？以下分享希望能你有所帮助我还能吃海鲜吗？根据宏观模拟结果表明，核污染水在排放后的天左右会到达我国沿岸海域。也就是说在这个月的时间以内，吃我们自己的海鲜还是没问题的。我需要囤盐吗？不需要。我国的盐主要来自井盐和矿盐，海盐仅占，整体是不受影响的。且光是青海察尔汗盐湖的湖盐储存量就有亿吨，够全世界吃上几百年。我还能去海边玩吗？目前还不清楚核污水排海之后到底会对人类和动物以及生物产生什么影响，但是起码再最近的个月时间内，我们是可以在国内的海边游玩。以下海鲜要少吃带鱼牡蛎三文鱼金枪鱼扇贝对虾梭子蟹秋刀鱼鱿鱼鳕鱼抗辐射食物姜黄生姜芥菜绿豆木耳木瓜黑枸杞黑芝麻运动生活研究称日本核污水排海天到达中国日本核废水我的运动日常;2;9;11;9387;0.0011718333865984873
长治超话关于日本排放核污水详细分析一，日本在国内建设日本学校，日本学校教育重点是什么？是正常教育，还是危害我国的教育行为，现在必须日日查清，二，日本为什么储存大量水资源，和日本排海有直接关系吗？三，日本为什么把储存在一个个储存罐里的致癌，致畸，致突变的核辐射水排放进海洋，日本排放进海洋里的核污水中其中之一的氚进入生物体内，会在细胞内横冲直撞直致毁坏挂掉细胞引起疾病，世界海水是互通的，核污水会通过太平洋周围循环海流分布，最后进入各个海洋，鱼类海产品被核辐射水吸收辐射污染，如果长期食用核辐射水污染食品，首先会造成对血器官，神经系统等损伤、或者更大疾病，引发海洋生物种群减少，核辐射水会通过大气循环被蒸发到云层，再形成雨水形式对地球造成严重影响，核污染水含有大量放射性物质，核污染水会随着大海流入大江大河，最终影响全地球全人类居住环境，如果，这个严重危害一旦形成肯定再无法逆转，我认为，日本隐藏在我们国家的间谍，应该一一查清，抓获。我们全球可以没有日本，但不能没有海洋。我们地球氧气是由陆上植物提供，而是由海洋里绿植提供，而这排放在海洋里的核辐射水对海洋里绿植能带来什么？，这其中的严重性自己想，对私自经营日本物品者必须严查;-6;32;26;9387;0.0027697880046873334
日本可能采取措施保障参加杭州亚运会的运动员的安全月日，据共同社报道，日本正在考虑采取措施，防止日本运动员在中国杭州举行的亚运会期间遇到麻烦。在此之前，受损的福岛核电站的放射性污水被排放入海。日本奥委会（）山下泰裕，本周三在东京举行的例行记者会上表示，正在与外交部和日本驻北京大使馆协调，看看需要采取什么措施：“视情况而定，我们希望与运动员进行适当的沟通，以避免任何麻烦。”他说，尚未向体育管理机构发出具体警告。日本计划派出大约名运动员参加亚运会，此时距离巴黎奥运会还有不到一年的时间。;12;42;54;9387;0.005752636625119847
平时都说自己爱国，日本排放核污水，你们怎么不说自己爱国了哔哩哔哩;1;0;1;9387;0.00010653030787258975
反对日本核污水排入海洋核废水排入大海坚决禁止日本核污水排放大海保护我们唯一的家园当当娱乐当当娱乐的微博视频;1;1;2;9387;0.0002130606157451795
华为浏览器日本福岛县甲状腺癌患者状告东电，民众集会声援评：支持日本人民维护生存权而生存权，又是最基本的人权。日本东电公司的最大股东是美国的贝莱德集团。那么一直打着民主、自由、人权牌坊的美国，就要为高调支持日本排放核污水付出代价。肩负起一个发达大国的责任，做好因福岛核电站核污水排放对日本人民造成伤害的相关赔偿工作，消除核污染源等，美国责无旁贷。现在受核污染危害最多的是日本人民，如果继续排放下去，后果不堪设想，美国、日本东电，悬崖勒马的时候到了。网页链接;3;78;81;9387;0.00862895493767977
我有选择困难症写思想汇报写时政我是写关于“逃出大英博物馆”还是写“日本排放核污水”帮我选选;2;1;3;9387;0.00031959092361776926
日本核污水排放处一个指标迅速升高潮新闻记者梳理日本东电公司官网发布的监测数据发现，自启动核污染水排海以来，号机取水口内检测出的铯元素含量明显高于以往。铯通常是核能反应、核爆炸或核事故的产物之一对人体有辐射危害，因为它会发射（贝塔）粒子和伽马射线。这些射线可以与人体组织相互作用，导致细胞损伤。中科院南海海洋研究所研究员陈更新曾在接受采访时指出，从扩散路径来看，日本核污染水会影响到中国南海、东海、渤海和黄海。北太平洋是其中严重的被污染区。事实上，全球都逃不掉日本核污染水的影响。;11;50;61;9387;0.006498348780227975
韩媒：日本拟扩大向韩国出口水产品据韩媒《京乡新闻》月日报道，日本为支持因排放核污染水而出口受阻的本国海鲜，正在推进扩大向韩国的出口。就《京乡新闻》提出的“污水排放后，新出口国家是否包括韩国的问题”，受日本政府要求正在开拓水产品销路的日本贸易振兴公社表示：此次对策中包括韩国市场，正在研究向韩国追加出口日本产水产品的可能性。解释说：“去年访问日本的游客中，韩国人占最多，他们访问日本的原因之一就是日本美食。因此，我们决定进一步开发市场。”表示，尚未与韩国政府讨论扩大海鲜销售渠道的事宜，但已在招募中间业务经营者，他们将发现想要进口更多日本农产品和海产品的韩国企业，“该计划的目标不仅仅是增加出口，我们认为满足相关企业的需求也很重要。”据海洋水产部统计，韩国平均每年进口日本水产品超过万吨，其中进口最多的是扇贝（吨）。扇贝也是日本受中国禁运打击最严重的商品。韩国从年月开始禁止进口福岛等核电站周边个县的水产品，但其他地区水产品进行放射性测试后可以进行进口。;84;621;705;9387;0.07510386705017577
坏消息：世界上没有炎龙侠更坏的消息：更没有禅定印更更更坏的消息：有污染海水的异能兽奥特曼日本排放核污水保护生态环境颜汽水的夏天的微博视频;1;1;2;9387;0.0002130606157451795
老兵带你看世界直击日本强排核污水后的情况岸田要哭了？中国赴日旅游团骤降郭正亮：日本的损失只会越来越大网友：海产卖不出去，旅游又泡汤，结果会越来越严重赶紧停止吧日本排放核污水的影响有多大品茶说酒的微博视频;39;227;266;9387;0.028337061894108874
日本排放核污水后最让人担心的事发生了卫星观地球的微博视频;185;1982;2167;9387;0.230851177159902
说真话知真相超话月日韩国两大在野党召开联合记者会，日出发前往欧美等国吁吁共同扺制杇污水排放，网友：国虽小，但硬气，但对于日本核污水一事，我佩服大部分韩国人星球之音的微博视频;6;50;56;9387;0.005965697240865026
专家曾称外星人不敢来地球让外星人去治一治日本那群排放核污水的人吧;4;13;17;9387;0.0018110152338340257
李在明如果没有李在明绝食这个话题，请问国人们还记得日本排放核污水这件事吗？绝食第天，很佩服，至少人家还在抗议日本排放核污水，而国人呢早已忘了核污水这件事了，还说风凉话，事不关己。但是养好身体才能更好的抗争，不管怎样希望他能进食;7;39;46;9387;0.004900394162139128
专家曾称外星人不敢来地球外星人：谁敢来啊哎哟一群专家天天建议就算了日本还居然排放核污水;1;3;4;9387;0.000426121231490359
日本排放核污水后，变异生物怪兽迟早出现，今天有很正常;1;0;1;9387;0.00010653030787258975
过来处理日本排放核污水的吗;2;2;4;9387;0.000426121231490359
这几年越来越频繁了。实在转移日本排放核污水这种重大且长久的消息嘛？？;1;0;1;9387;0.00010653030787258975
外星人我只希望可以关注日本排放核污水，就没人管管么;3;1;4;9387;0.000426121231490359
现在资本在用，预制菜等在分流核污水的影响力，大家千万要多搜核污水，多发帖多点赞，不要买日本的所有东西，不要吃进口的鱼，能用国产，尽量用国产。小日本会换包装和产地继续卖到中国来，已经有人吃到辐射三文鱼了请在外国的网友或者能上外网的朋友多在国外宣传下，核污水是含有很多放射性的水，你们看日本人展示出来的是清水，但是排放到大海的是污浊的混水就知道了，为什么颜色不一样？？因为含量不一样。而且海洋里的小动物都会生病，会长着两个身体三个脑袋，还会得癌症，但是它们没有医生，像海豚、海獭、海豹还会随着污染被迫离开栖息地，而且随着动物的食物链和洄游还有洋流，日本核废水辐射遍布全世界。日本核废水排放极端自私日本核废水排海已经开始影响邻国日本核废水;11;399;410;9387;0.0436774262277618
如果真的有外星人，那请去把日本排放核污水的人灭了给人类赔罪整个人类都会感谢你;1;2;3;9387;0.00031959092361776926
日本核污水全世界又是只有我们反对从另一个角度看，如果这个排放是不达标的，国际社会的其他各国（包括日本本国）不可能会自寻灭亡日本核废水在排放前是经过国际原子能机构长达两年的检测（其中包括中国核电专家，当时并未提出反对意见）现在全网挑起的民族对立情绪是出于什么目的呢？再回头看下新冠曾经也是与世界各国做法完全不同，最后还是迫于社会舆论压力放开（长达三年的封闭管理）那么谁对谁错？;2;4;6;9387;0.0006391818472355385
前几天因为日排放核污水的原因，都抵制日产，我还在说，怎么可能抵制完呢？每一个手机的镜头模组都来自日本。华为感觉真的真的要做出镜头模组来了不知道咋说才能表达这种震惊的心情，很伟大，我们也有徳式的工匠精神了;1;2;3;9387;0.00031959092361776926
外星人日本排放核污水墨西哥发现外星人是不是不久世界就要毁灭了可以不考四六级不考研不考公不考教资了吗;1;0;1;9387;0.00010653030787258975
听了这张专来看的，震撼到我在班车上哭到不能自己。关于告别三个时间版本的歌曲，在专辑中顺序是从近到远，直到看了剧才发现顺序是倒过来的，甚至最动感的两首出现的场景并非真实，而初听看似深情的，出现在剧中却是人物悲凉的境遇。再听真是绝妙。另外就是望远镜之外的景色，当初在里约奥运会“东京八分钟”听到就爱上了，还很好奇为什么是这个名字，今天才知道出处，“把望远镜拿反，远处的景色会变小，过去也会变得更加遥远”逃离了望远镜之内的记忆，但之外的景色却永远在那。野田秀树太敢了，林檎女王我永远的神不说了能把出自这部剧的歌曲带到奥运会上展示国家形象，用意可想而知）然而谁能想到望远镜之外的今天日本排放了核污水;1;1;2;9387;0.0002130606157451795
有日本官员在东京接受不具名专访被问到早前香港特区政府有兴趣参与监察核污水排放时回答，日方认为国际原子能机构（）在核电方面最具权威，应尊重获国际认可机构的监察，这才是最公平和公正的取态。哦意思是，我给你说安全就安全，不需要监察。呵呵，既然安全，那为何不敢大大方方？黄媒不会说的真相;10;44;54;9387;0.005752636625119847
渔民有什么错？只是生活罢了渔民网暴日本排放核污水快乐的猩球的微博视频;0;3;3;9387;0.00031959092361776926
苹果新品发布会但凡环保一点都不至于一直支持日本排放核污水在一个手机这里号召环保碳中和，你在搞笑呢这么爱政治正确，滚吧;1;1;2;9387;0.0002130606157451795
日本首轮核污水排海“圆满成功”当地时间月日正午，日本福岛第一核电站核污染水首轮排海作业结束，总计向太平洋排出吨核污水。根据东京电力公司的计划，接下来将进行设备检查，最早将于月底开始第二轮排海，今年将分次排放万吨核污水。日本环境省日表示，自月日排海以来，在福岛第一核电站周边海域进行每周一次的海水监测，截至日该省网站发布的三次监测结果显示，所有个监测地点的氚浓度均低于（贝克勒尔升），低于世界卫生组织的饮用水水质指标。另一方面，国际原子能机构（）月日称，该机构在福岛第一核电站附近公里海域进行独立采样分析，样本的氚浓度均低于。实际上，核污染水中除了氚之外，还有锶、锶、钴、碘等多种核素，目前为止仍然没有详细数据来证实这些核素对海洋生物的影响究竟有多大。东电方面声称，核污水经过了多核素处理设备（）等的处理，除氚之外的放射性核素均降至标准值之下。福岛县磐城市小名浜鱼市场办公室工作人员称，该市场负责当地所有渔获物的放射性物质检测，检测对象为核素铯和铯，设定的安全标准值为，相比福岛县渔业协同联合会设定的标准和日本国家标准更为严格。截至日未发现放射性物质超标的样本。新闻综合报道;8;10;18;9387;0.0019175455417066154
日本核燃料研究所放射性物质泄漏近日，日本原子能研究开发机构下属的位于茨城县东海村的核燃料循环工学研究所发生放射性物质泄漏。研究所称，放射性物质泄漏未对工作人员健康和周边环境造成负面影响。日本在核安全上是劣迹斑斑，其中最触目惊心的东海村临界事故不知道大家还记不记得？年的时候，日本东海村一家核燃料制备厂因为管理疏漏发生临界事故，导致多人被核辐射污染。其中一个工作人员大内久因受大量核辐射伤害，细胞无法再生，在被治疗的天里，只能亲眼看着自己的身体一点一点地腐烂死去。最近这几年，大大小小的核事故也是频繁发生，每次除了撒谎隐瞒，鞠躬道歉，就没见过反思悔改，日本现在说的话，做的事早已不值得信赖，核污水的排放也是一样。;205;1333;1538;9387;0.16384361350804305
法国决定禁售法国又在发什么神经，前有必须用口，现在拿辐射说不让卖，辐射再大有核污水大？咋不见你们禁止日本排放核污水;4;17;21;9387;0.0022371364653243847
法国决定禁售艹，日本非法排放核污水，最先中招的竟然是苹果;2;24;26;9387;0.0027697880046873334
强烈要求日本停止排放核污染水，强烈谴责日本不负责任的做法，大海不是日本的下水道，要求重新审视合法合规无害化处理核污染水，中国入驻进入日本福岛设立核污染检测点，强烈谴责日本排海计划日经中文网俄罗斯驻华大使馆寒国人台湾孤烟暮蝉黄智贤星球来点石锤日本国驻华大使馆日经中文网乌合麒麟核污染日本核污水核污染水排海计划日本;1;1;2;9387;0.0002130606157451795
红烧牛腱子超话万恶得日本居然向大海中排放核污水变异物种正脸照流出;1;0;1;9387;0.00010653030787258975
泰国对中国实施个月免签政策泰国是缅北电诈最大的东南亚受害国毕竟泰国旅游是靠着中国人才撑起来的。曾经的新马泰，名声已经变成了嘎腰子的代名词日本排放核污水，缅北一带电诈活跃，如今看，韩国可能是中国游客的十一首选了;8;639;647;9387;0.06892510919356556
日本一官员因坦称“核污水”，被官僚集团们排挤辞职。核污水排放是日本权贵集团联合美国资本家谋划的有史以来最严重的恐怖袭击。将会给地球生态、给人类带来长久的、巨大的伤害。赵铮同志的微博视频;15;95;110;9387;0.011718333865984873
遭核污染水打击的日本水产品，将扩大对韩国的出口据悉，日本为了支援因排放核污染水而出口受阻的本国水产业，正在推进扩大日本产水产品对韩国的出口。就《京乡新闻》提出的“污水排放后，新出口国家是否包括韩国的问题”，受日本政府要求正在开拓水产品销路的日本贸易振兴公社表示此次对策中包括韩国市场，正在寻找能否向韩国追加出口日本产水产品的可能性。韩国从年月开始禁止进口福岛等核电站周边个县的水产品，但其他地区水产品以实施放射能检查为条件进行进口。（后略）;23;215;238;9387;0.02535421327367636
一个小小的心愿：海洋核污水排放源头尽快消失富士山喷发或是从俄罗斯飞过去的导弹日本计划明年月底前排放轮核污染水;1;5;6;9387;0.0006391818472355385
日本计划明年月底前排放轮核污染水日本最快将于月上旬启动第二轮排放。根据东京电力公司此前公布的计划，到明年月底为止，东电将对核污染水进行轮排放，排放总量约为吨，占到目前核污染水总量的，相当于排空大约个储罐。纪实科教的微博视频;1;0;1;9387;0.00010653030787258975
日本排放核污水，造成大量鲸鱼死亡，日本鬼子真邪恶日本核污染水排海天后海洋啥样吨核污染水已排入海洋早安超话鶄畫的微博视频;15;162;177;9387;0.018855864493448386
自然之母怎么看待日本恶意排放核污水送心;2;3;5;9387;0.0005326515393629487
核污水首轮排海结束日本现状如何？日本福岛渔获主打自主检测据日本读卖新闻报道，在对首轮核污染水的排放结果进行确认后，最快将于月上旬启动第二轮排放。根据东京电力公司此前公布的计划，到明年月底为止，东电将对核污染水进行轮排放，排放总量约为吨，占到目前核污染水总量的，相当于排空大约个储罐。其他超过个储罐的核污染水，将在今后几十年内陆续排出。日本计划明年月底前排放轮核污染水（小央视频）;0;4;4;9387;0.000426121231490359
国人的注意力好容易被转移，先是，然后李佳琪，这些事情真的很重要吗需要用到那么多的公共资源，社会舆论不断发酵吗核污水是和每个人息息相关的，关乎生命的人的精力会被消耗的，几件热点时间一发，大家就忘了反对核污染排放，国外资本借机宣传日货，前功尽弃。小日本骨子里面透出来的坏让世世代代都觉得恶心愿祖国繁荣昌盛山河无恙全球无日本研究称日本核污水排海天到达中国;1;10;11;9387;0.0011718333865984873
日本研究机构发生放射性物质泄漏加拿大山火烧了几个月了，日本核污水也排放了，现在又有放射性泄漏，事情到了这里，敢问平时那些什么环保组织，动保组织，什么瑞典小公主，柴静们怎么连个屁都不敢放;22;287;309;9387;0.03291786513263023
福岛核污水首轮排海结束当地现状观察日本福岛核污水首轮排海结束，当地现状如何？日本水产品价格下跌当地时间月日正午，日本福岛第一核电站核污染水首轮排海作业结束，总计向太平洋排出吨核污水。根据东京电力公司的计划，接下来将进行设备检查，最早将于月底开始第二轮排海，今年将分次排放万吨核污水。根据新华社报道，月日，名渔业从业者向福岛地方法院提起集体诉讼，包括福岛、岩手、茨城、东京等地的渔民，他们控诉日本政府和东京电力公司的核污水排海行为侵犯了渔民的捕鱼权，还威胁公民和平生活的权利，要求立即停止。对于日本国内尤其是福岛当地来说，水产品的安全、销路和声誉现今如何？日本计划明年月底前排放轮核污染水全文;23;63;86;9387;0.009161606477042719
日本计划明年月底前排放轮核污染水省流：加速了排放核污水预估六个月内排出的核污水占总量也就是说本来年排完的，现在缩短到年;10;154;164;9387;0.017470970491104718
日本计划明年月底前排放轮核污染水核污水事件就是很玄想不明白;1;0;1;9387;0.00010653030787258975
核污水首轮排海结束日本现状如何日本排放核污水的后果，就是未来日本福岛海岸的死鱼遍地。未来日本福岛的海岸上，会到处漂浮着各类死鱼、海洋生物。这次国际社会，已经针对日本福岛核泄漏的废水进行了计算，完全可以增加一部分储存罐，就能解决储存问题，而且占地面积非常小，可以忽略不计。日本之所以排放核污水，并不是因为没有地方储存。但是日本仍执意要把核污水排进海里，就是想恶心、扰乱全世界，日本人的坏是刻在骨子里的。日本人坏起来，连自己的国民都不管不顾（视频为网络配图）;11;109;120;9387;0.01278363694471077
日本计划明年月底前排放轮核污染水日本，《读卖新闻》报道称，在对首轮核污水排放结果进行确认后，最快将于月上旬启动第二轮排放。现在还有人对这事还关心吗？除了刚开始排那几天大家都感到愤怒和恐慌以外，才过去一个多月吧，一切都恢复平静了。算了，不谈了，不然又要惹事了，该干嘛就干嘛吧。;1;1;2;9387;0.0002130606157451795
日本右翼分子呼吁日本民众多吃福岛海鲜，弥补直接损失。日本福岛福岛核污水日本计划明年月底前排放轮核污染水会火大叔的微博视频;-5;4;-1;9387;-0.00010653030787258975
日本计划明年月底前排放轮核污染水日本想省钱办大事，未必行得通历史会记住的日本为什么要污染海洋？一方面是是日本不负责任，没有考虑到海洋生态问题，试图通过冒险的方式，将污染甩锅给海洋，减轻自身压力；另外一方面，日本不愿意在核污水处理上进行大笔投资，要以最小的代价来解决核污水问题。海洋那么大，一旦核污水排放，势必对周边国家产生影响，面对很多未知的风险，日本已经失去了底线，如果真的产生后果，日本将会再被历史记上一笔。目前我国海关已经宣布，全面暂停进口日本水产品，相信接下来还有其他措施，日本想省钱办大事，未必行得通;3;8;11;9387;0.0011718333865984873
日本计划明年月底前排放轮核污染水这是日本核污水排放的第天，日本已排放超吨核污染水，明年月底前排放轮核污染水，我们一起顶顶热度，要坚持抵制日货，而不是越到后面越消极，一个人的声音很小，需要大家共同发声，拒绝麻木，不做冷漠的看客能传播信息的尽量传播，让国内外更多的人知道日本的罪证;0;287;287;9387;0.030574198359433258
利比亚东部洪灾遇难者已超人这是人祸，不是天灾。科普一个热知识：《核辐射云》年月日福岛核电站因地震出事的新闻讲，日本核辐射云扩散，天内抵达美国西海岸。微量核物质乘长风直下北美，乃至在整个地球西风带飘落。年月日核污水排放是入秋，全球风带图，自行琢磨（高中地理知识）日本计划明年月底前排放轮核污染水;-17;5;-12;9387;-0.001278363694471077
日本计划明年月底前排放轮核污染水现在的感受是，没有哪个国家制止得了日本吗？核污水的污染具体真实是什么情况？这不应该是全人类的公敌吗？一堆问号李在明绝食天说话困难李在明停止绝食;690;11;701;9387;0.07467774581868541
日本反对他国直接取样独立检测这太糟糕了日本政府能不能硬气一回，逮捕一批政府里和东电沆瀣一气的官员，开放第三方独立监测，倒逼核污水有底线的排放美国政府也当高度关注，日本既不是真儒家又不信奉基督教，是一个一级对只对上一级负责的工业文明社会中的落后蛮人部族，必须老大哥直接动手一顿暴打，才有可能葆有良知与底线;2;154;156;9387;0.016618728028124002
健康科普超话抗核辐射日本核污水排放后天，就会到达我国沿岸海域，现如今还有天了，我们现在急需为抗辐射做好准备。补硒是关键;0;1;1;9387;0.00010653030787258975
老兵带你看世界直击一线情况福岛民众自发监测海鱼核辐射：想凭自己的力量找到决定性证据，我们希望和中韩民众一起，阻止排放核污水网友：必须一直反对，必须制止，这是慢性谋全人类日本排放核污水的影响有多大品茶说酒的微博视频;4;34;38;9387;0.004048151699158411
粤港澳小小胖超话日本核废水排放极端自私时事观察集结号：日本核污水背后的恶念链接：网页链接提取码：;4;15;19;9387;0.0020240758495792053
日本不淡定了，特朗普嘲讽日本核污水排放，是美国的福音一些人多喝日本反对他国直接取样独立检测正义小黄鸭的微博视频;34;316;350;9387;0.037285607755406416
日本核污水排海的后果后果很严重。咱慢慢说。先说对日本的后果。日本政府在核污水排海的考虑中，考虑到了核污水排海口的深度，海水的温度，核污水的浓度，管道的长度，排放的频度；想充分利用海水垂直水深千米以下结晶层效应降低污染，然后，又，一举多得。但是，聪明反被聪明误。海水本就具有电磁效应，地球也有电磁效应，海水温度是海水热力状态的物理反应，核污水是海水热力状态的干扰剂，日本本就是地震多发之地，核污水本来就是级地震的后果，难道日本是想用核污水去报复地球？还是想再和地震较量较量？下篇说对美国的后果。;2;1;3;9387;0.00031959092361776926
每天一点干货，核污水排放后的点营养建议，早安核污水排放后，除了避免与核辐射亲密接触，还要避免比如食用受核辐射污染的生物等，所以可以通过营养方案抵御或减少核辐射对人体造成的伤害，文献资料显示，可参考以下个营养建议健康核污水日本核污染水下午排入海洋微博健康公开课;1;0;1;9387;0.00010653030787258975
福岛核污水首轮排海结束当地现状观察日本福岛核污水首轮排海结束，当地现状如何？日本水产品价格下跌当地时间月日正午，日本福岛第一核电站核污染水首轮排海作业结束，总计向太平洋排出吨核污水。根据东京电力公司的计划，接下来将进行设备检查，最早将于月底开始第二轮排海，今年将分次排放万吨核污水。根据新华社报道，月日，名渔业从业者向福岛地方法院提起集体诉讼，包括福岛、岩手、茨城、东京等地的渔民，他们控诉日本政府和东京电力公司的核污水排海行为侵犯了渔民的捕鱼权，还威胁公民和平生活的权利，要求立即停止。对于日本国内尤其是福岛当地来说，水产品的安全、销路和声誉现今如何？全文;4;6;10;9387;0.0010653030787258974
福岛核污水首轮排海结束当地现状观察日本福岛核污水首轮排海结束，当地现状如何？日本水产品价格下跌当地时间月日正午，日本福岛第一核电站核污染水首轮排海作业结束，总计向太平洋排出吨核污水。根据东京电力公司的计划，接下来将进行设备检查，最早将于月底开始第二轮排海，今年将分次排放万吨核污水。根据新华社报道，月日，名渔业从业者向福岛地方法院提起集体诉讼，包括福岛、岩手、茨城、东京等地的渔民，他们控诉日本政府和东京电力公司的核污水排海行为侵犯了渔民的捕鱼权，还威胁公民和平生活的权利，要求立即停止。对于日本国内尤其是福岛当地来说，水产品的安全、销路和声誉现今如何？日本计划明年月底前排放轮核污染水全文观察日本福岛核污水首轮排海结束，当地现状如何？;113;876;989;9387;0.10535847448599127
福岛核污水首轮排海结束当地现状观察日本福岛核污水首轮排海结束，当地现状如何？日本水产品价格下跌当地时间月日正午，日本福岛第一核电站核污染水首轮排海作业结束，总计向太平洋排出吨核污水。根据东京电力公司的计划，接下来将进行设备检查，最早将于月底开始第二轮排海，今年展开;6;6;12;9387;0.001278363694471077
此外核污水排放前一段时间，国外也曾有多篇质疑的文章，只是日本在投放了一些媒体公关费之后，各国媒体上明显质疑声音少了。;1;5;6;9387;0.0006391818472355385
核污水首轮排海结束日本现状如何？日本福岛渔获主打自主检测据澎湃新闻当地时间月日正午，日本福岛第一核电站核污染水首轮排海作业结束，总计向太平洋排出吨核污水。根据东京电力公司的计划，接下来将进行设备检查，最早将于月底开始第二轮排海，今年将分次排放万吨核污水。日本环境省日表示，自月日排海以来，在福岛第一核电站周边海域进行每周一次的海水监测，截至日该省网站发布的三次监测结果显示，所有个监测地点的氚浓度均低于（贝克勒尔升），低于世界卫生组织的饮用水水质指标。另一方面，国际原子能机构（）月日称，该机构在福岛第一核电站附近公里海域进行独立采样分析，样本的氚浓度均低于。然而，无论是还是日本环境省，目前为止发布的检测结果仅涉及放射性核素氚，东电发布的海水取样报告也只包含氚、铯、铯。实际上，核污染水中除了氚之外，还有锶、锶、钴、碘等多种核素，目前为止仍然没有详细数据来证实这些核素对海洋生物的影响究竟有多大。对于日本国内尤其是福岛当地来说，水产品的安全、销路和声誉现今如何？;1;7;8;9387;0.000852242462980718
日本反对他国直接取样独立检测咱就是说这闸开了就关不上是吧？真就应了小日子说的他们了解中国，过不了几天就忘了这还没几天呢，大家也不关心这闸能不能关上，能不能让日本不排放核污水日货销量不降反增，国货趁机大涨世界人的记性也是这样，时间会让人忘记一切。独独小日子每天都在展开;4;114;118;9387;0.01257057632896559
日本反对他国直接取样独立检测台湾媒体说日本核污水的排放是“圆满结束”，在日本这样各种心虚的情况下，我可不觉得是圆满。日本计划明年月底前排放轮核污染水;3;48;51;9387;0.005433045701502077
日本反对他国直接取样独立检测咱就是说这闸开了就关不上是吧？真就应了小日子说的他们了解中国，过不了几天就忘了这还没几天呢，大家也不关心这闸能不能关上，能不能让日本不排放核污水日货销量不降反增，国货趁机大涨世界人的记性也是这样，时间会让人忘记一切。独独小日子每天都在想着如何嚯嚯中国就特么离谱今天我看一个官方公众号还发了一个推文，说什么“以日式服务之道，给顾客以极致的购物体验”，日子的思想渗透可真厉害，让大家觉得日本的服务真好啊所谓的“日式服务之道”，就是拉着全世界陪葬，也要排放危害及其大的核污水日本已排放超吨核污染水;4;114;118;9387;0.01257057632896559
太难受了，半夜做梦梦到日本排放核污水，来报应了假期回到家先是天灰灰后来弥漫着黄色的雾气再变成黑色的，家里赶紧关窗再下雨打雷刮风家旁边的江水涌出来还是黄色的，最后发大洪水身体被雨水淋到之后浑身发酸关键是老妈还在外面没回来日本核污水去吧;1;0;1;9387;0.00010653030787258975
日本反对他国直接取样独立检测关于日本向太平洋排放核污水这事，西方对日本采取了默认态度。这事从国际原子能机构的态度上就能看出来，表示排海计划“符合安全标准”，但“不建议”日方这么做。;3;7;10;9387;0.0010653030787258974
美国默认日本排放核污水的行为是我不买日推出任何一款产品的根本原因日本核污染水排海正式开始美国超话;0;1;1;9387;0.00010653030787258975
万自卫队带头吃海鲜，岸田文雄敦促我们一起吃，你会答应吗？日本计划今年次排放核污染水就在多个国家禁止进口日本海产品之际，日本防卫省却带头购买福岛出产的水产品，但日本全国也就万自卫队成员，怎么吃的玩全日本的水产品呢？所以，岸田文雄此前表示：将抓住双边、多边的机会，活用世界贸易组织、区域全面经济伙伴关系协定（）等贸易框架，来促使我国撤销禁令。这是要拉着咱们一块吃啊你会答应吗？不管日本怎么演，全世界都不敢吃海产品将是未来大趋势毕竟，东京电力公司的储水罐里一共有万吨核污水，以目前一次排放吨的速度，要花年时间才能排放完毕以后大海里的东西还能吃吗？谁还敢吃？而且在污水转运过程中有过泄漏，当地雨水中已经检测出了超标辐射，这就意味着福岛乃至全日本陆上的农产品也是有风险的。不过还好，咱们可是有万平方公里的超级大国，海里的鱼虾不能吃，咱们能陆上养殖比如重庆的“山城海虾”已经上市了，产能有望在短期内突破万吨相信其他海产品也已经在规模养殖的路上了。我们不妨展望一下未来，塔克拉玛干沙漠万平方公里的面积变成内陆海洋，专门养殖海产品，也是有可能的;5;24;29;9387;0.0030893789283051028
大学时期就粉的一个博主，小日本排放核污水之后还继续推日本的牌子，就让人很，好意提醒了一句，她也回复了，没想到没几天又开始秀她买到的日货，粉了那么多年的博主没有点民族大义，这种感觉跟吃了屎一样难受;1;2;3;9387;0.00031959092361776926
日本反对他国直接取样独立检测，再正常不过了。日本排放核污水本身就是有问题的。问题之下，自然要保证消息出口。这是常识问题。这要是让国外参与了检测，他们那套没危害的说辞不就被戳穿了吗？你是日本的政客，你会让周边国家直接取样检测吗？;9;316;325;9387;0.03462235005859167
这一宿舍都是人啊你买的日货将会化作一把利剑刺向自己和同胞的身体，你亲手断送了人类的未来。拒绝麻木，所以请不要做冷漠的看客正如鲁迅先生的说的：“你可以躲在角落里沉默，但是不要诋毁和嘲笑比你勇敢的人，因为他们争取到的光明也许会照耀到你”这件事与我们每个人息息相关，抵制日货生命高于一切我没有针对任何真正喜欢日本好产品的人的意思，日本想置我们于死地，日本经济有在中国，我们抵制他们的东西，他们因为经济会重新考虑排放污水的情况，如果核污水持续排放，排放年，会严重影响我国，影响我们的生命安全，你的生命应该比日本经济更重要;1;0;1;9387;0.00010653030787258975
日本中华学校下午点半放学你买的日货将会化作一把利剑刺向自己和同胞的身体，你亲手断送了人类的未来。拒绝麻木，所以请不要做冷漠的看客正如鲁迅先生的说的：“你可以躲在角落里沉默，但是不要诋毁和嘲笑比你勇敢的人，因为他们争取到的光明也许会照耀到你”这件事与我们每个人息息相关，抵制日货生命高于一切我没有针对任何真正喜欢日本好产品的人的意思，日本想置我们于死地，日本经济有在中国，我们抵制他们的东西，他们因为经济会重新考虑排放污水的情况，如果核污水持续排放，排放年，会严重影响我国，影响我们的生命安全，你的生命应该比日本经济更重要;4;32;36;9387;0.003835091083413231
果然美国机长开飞机就会坠机，不如支持一下我们《中国机长》，我怀疑这次坠机是光明会的阴谋，靠美国人查理苏的热度转移疯马秀和日本狐狸齐司礼排放核污水的热度，而且未婚夫的毛是银灰色的吧，太深了，不要用一支的花西子给他画眉毛;1;57;58;9387;0.0061787578566102055
室友：日本排放核污水我现在看动漫都不敢光明正大的看了;1;5;6;9387;0.0006391818472355385
日本反对他国直接取样独立检测，之前亿还在洗我们“拒绝日本邀请”，这下日本连你直接取样独立检测都不给了。核污水如果在日本本国处理、排放，我们也没必要去关注这些，现在他往太平洋里排，还不给你采集他的核污水样本，这不是心里有鬼是什么呢？;190;5191;5381;9387;0.5732395866624055
就在日本排放核污水的那几天温州突然在某一天下了一场超大的雨当时我在睡觉睡了之后天突然变得好好黄好黄感觉世界末日来临了一样第一张图是那天我家后门的样子好美这个小狗是张送给我的给它戴上了我的发箍哈哈本来前几天收拾行李已经把它带上了结婚我妈又把它出去了只能十一的展开;1;6;7;9387;0.0007457121551081282
日本不敢排放核污水了吗？改邪归正了？如果是这样，还真是个好消息;4;8;12;9387;0.001278363694471077
核污水个新情况，事实证明：中国的判断没错，岸田的麻烦全来了。目前，日本第一批核污水排海，已经在本月号结束了。据统计，此次一共有吨污水入海。接下来，如果按照日本人的计划，他们还会在月底开始第二批排放。整个年，他们一共计划了次排污。而按这个排法，整个行动将进行至少年。岸田文雄的算盘打得很精，但他始终不明白：这个世界，做什么事都是需要付出代价的，或早或晚。这不，就在这几天，两个新情况出现了。而这两个情况，恰恰说明：中国早前的判断没错第一个新情况，是来自俄罗斯方面。自从中国全面暂停对日本水产品的进口后，这块市场就空了出来，不少国家都有增加对华出口的意向。其中，走在最前面的就是俄罗斯。这两天的消息显示，目前又有家俄罗斯渔业企业获准对华出口产品。对俄罗斯来说，这当然是个好消息。而对日方来说，这说明早前的一种说法被打破。早前，曾有日本网友放出话来，称：“日本水产品对中国来说，是不可替代的。”为此，他们还列举出了不少日本“特有”的水产品。但事实上，中国的禁令生效这么多天，并没有出现任何日方预料的“中国吃货受不了”的情况。而现在，随着俄罗斯等国渔业的补进来，不排除过几个月，日本这块市场将被其它国家全部占完。第二个新情况，来自岸田政府。就在这几天，日媒曝出消息：岸田政府在号改组内阁，把整个高层人事安排都重新规划了一次。对日本政界来说，这是一次大地震，这意味着：不少岸田亲信可能要下台了。对此，评论认为：这是岸田文雄在“断臂求生存”。因为现在，岸田内阁的民意支持率已经降到，这在日本政界是非常低的。日方认为，只要低于了，就是一个“危险水域”。在此之前，岸田政府已经想过不少办法，希望拉一拉支持率。然而，现在看来，早前做的一切都是无用功，除了改组再无它法。走到这一步，日本媒体认为原因是多方面的：经济低迷，让民众对内阁失去信心；与中国、俄罗斯等国的关系紧张，让民众产生不满；就是这次污水排海的问题。目前，福岛县和宫城，已经有多人向法院起诉日本政府和东电公司，要求停止污水排放，并对他们进行赔偿。以上，大家看清了没，事情根本不是像一些日本政客说的那样“只有中国人反对”，连他们日本国内都有大批人不满，更别提其它亚洲国家的民众。以上两个情况，无疑暴露了岸田政府目前的困境。这也说明，早前中国对他们的判断并没有错，他们排污的做法就是损人而又不利己的。当然，目前对我们中国来说，需要特别注意的是：不排除岸田政府为了转移国内矛盾，反复将矛头指向中国。早前，日本方面已经向递了文件，“状告”中国，要求中国重新开放对日本水产业的进口。对此，咱们中国倒完全不虚。一来，理本来就在中方这边，咱也不怕在和他们论战；另一方面，关于这种类型的“上诉”，有一个较长时间的流程要走，以往的案例，动不动就是几年时间都没有个结果。因此，整体来说，的事对当下的局面倒是形成不了客观的影响。倒是岸田文雄内阁还能不能挺到事情有结果那一天，就真的不太好说了。;4;169;173;9387;0.018429743261958027
没想到东京奥运开幕式竟是预告片东京奥运开幕日本排放核污水海洋生物甜乃奈的微博视频;1;1;2;9387;0.0002130606157451795
富士山啊富士山下紫微星日本排放核污水甜乃奈的微博视频;1;3;4;9387;0.000426121231490359
日本计划明年月底前排放轮核污水，占目前总量的月日，央视援引《读卖新闻》报道称，在对首轮核污水排放结果进行确认后，最快将于月上旬启动第二轮排放。根据计划，到明年月底，东电将对核污水进行轮排放。日本核污染水首次排海今日结束网页链接七环视频的微博视频;2;0;2;9387;0.0002130606157451795
日本计划明年月底前排放轮核污水，占目前总量的月日，央视援引《读卖新闻》报道称，在对首轮核污水排放结果进行确认后，最快将于月上旬启动第二轮排放。根据计划，到明年月底，东电将对核污水进行轮排放。小央视频的微博视频;3;6;9;9387;0.0009587727708533077
掷地有声日本排放核污水态度日本人甜乃奈的微博视频;1;3;4;9387;0.000426121231490359
有谁能不信这个“日本梦”是真的？有多少国人会不惧怕？排放核污水还仅仅只是日本人实施“日本梦”的开始震憾日本梦是什么？日本第二批核污染水或月底排海花西子客服回应网传工厂在日本;1;2;3;9387;0.00031959092361776926
日民众游行抗议核污水排海月日，日本数百名民众走上东京街头，抗议福岛第一核电站向太平洋排放核污染水。今日俄罗斯的微博视频;12;279;291;9387;0.031000319590923617
当我新买了一瓶洗发水据说还是很好用的那种期待了好几天，到货后发现产地是日本时我的心情：配料表还是日本温泉水呢大概唯一值得庆幸的是它的生产日期比公布核污水排放日期早;2;0;2;9387;0.0002130606157451795
日本排放核污水怎么解释？你还知道电磁辐射？;1;49;50;9387;0.005326515393629488
帝吧超话核污水日本日本排放核污水的热度不能降每天都要发一遍揭露小本子正在进行的反人类罪行桥边男孩的微博视频;0;59;59;9387;0.006285288164482795
日本正式宣布，核污水首次排海结束首次排出了约吨，预计第二次排放将于本月下旬开始。开工没有回头箭，踏出了危险的第一步，这种对极不负责任的行为看来还会继续下去。日本核污水排海之后，海鲜的安全性还有待检验，但我国已经有了应对措施。重庆刚刚宣布，首批内陆养殖的“山城海虾”已经在盒马上市了实实在在被震惊了，这辈子也没想到内陆能产海鲜。你没看错，是远离我国海岸线的重庆。山城没有海，就自己造海在内陆地区居住的朋友可能会有同感，虽然物流进步了，但重庆市民要想吃到海虾，最近也得从公里外的广东湛江运。成本很高不说，等送到了，虾的活力也不高了。现在直接在陆地建厂养虾，通过技术攻关，人工模拟出海洋环境，而且为了达到生态平衡，不添加任何抗生素，循环使用“海水”，不对外排放造成污染。看到基地负责人的介绍，我心生诸多感慨。常有人说，日本的民族性格是“有小礼而无大义”，道歉比谁都勤快，缺德的大事一件没少干。如果以日本人的视角，连核污水都能往大海里排了，区区养虾厂的废水又算啥呢？现在山城海虾在盒马每天都供不应求，负责人还会继续加大产能，明年能达到万斤。期待咱们安全可靠的内陆好虾能造福更多消费者;3;7;10;9387;0.0010653030787258974
今天上课讲到环境污染很多学生都提到了日本排放核污水事件大家都畅所欲言谴责的做法这时有个学生站起来说：大家别担心，富士山三十年后就会喷发了我：啊真的吗？学生：真的（非常认真的表情我：你从哪里看到的啊？老师都不知道学生：我从网上看到的，富士山已经在冒烟了可笑死我了这些孩子;1;1;2;9387;0.0002130606157451795
教授要是知道了日本排放核污水的消息一定会很心痛吧。;1;0;1;9387;0.00010653030787258975
东方甄选主播调侃“是个好日子”你怎么不评论？日本排放核污水李佳琦第一时间终止与日系品牌合作的时候你怎么不发声？网络环境已经很差了，现在的网络根本听不得半句不同意见。作为央媒，不制止网暴就算了，还要再来添把火，给别人扣个大帽子;1;338;339;9387;0.03611377436880792
韩水产商贩称生意大跌成韩国海洋水产部月日表示，日本排放核污水后，韩国三大连锁超市消费额反呈上升趋势，水产方面销售也并没有受到很大影响。然而效果是否真如韩国政府的预期？凤凰记者来到首尔鹭梁津水产市场实地探访，有水产品商贩表示，销售额大概减到了一半，“日本核污水排海后，客展开;2;3;5;9387;0.0005326515393629487
日本将用亿日元处理核污染水负面信息可真的是还是花钱搞公关的有用，看这不热度下去了，时间久了人类就遗忘了？这片海洋呢？谁为它们发声？小日本毁灭吧所有支持排放核污水的人都该死;1;1;2;9387;0.0002130606157451795
强烈谴责日本排放核污水核污水海在哀鸣日本排放核污水动物保护环境日本核污水排海最新消息日本核废水排海超话日本核废水排海超话茶田汀饮品店的微博视频;1;4;5;9387;0.0005326515393629487
我要用唾沫星子淹死他日本核污水在逃叭叭鸭的微博视频;6;91;97;9387;0.010333439863641205
日本反对他国直接取样独立检测日本排放核污水日记中国长安网安哥，我要告状，我只是记录一下日本排核污水的时间，正常发关于日本排核污水的信息，没有诅咒，没有辱骂，也没有伤害中日两国友谊，中肯中正的帖子，一直被屏蔽，被限制。微博是不是有问题？再查一下他们吧。;5;17;22;9387;0.0023436667731969747
日本计划明年月前排放吨核污水，占目前核污染水总量的据日媒报道，在对首轮核污染水排放结果确认后，最快将于月上旬启动第二轮排放。根据东京电力公司此前公布的计划，到明年月底为止，东电将对核污染水进行轮排放。排放总量约为吨，占目前核污染水总量，相当于排空大约个储罐。其他超过个储罐的核污染水将在今后几十年内陆续排出。日本计划明年月底前排放轮核污染水九派新闻九派新闻的微博视频;2;7;9;9387;0.0009587727708533077
大自然终于出手了日本排放核污水地震台风甜乃奈的微博视频;-1;2;1;9387;0.00010653030787258975
碧蓝的大海却渐渐满目疮痍日本排放核污水大海海洋生物甜乃奈的微博视频;1;1;2;9387;0.0002130606157451795
我等还没出手思密达依旧稳定发挥韩国网友战斗力日本排放核污水甜乃奈的微博视频;3;108;111;9387;0.011824864173857462
日本东电排放核污水的背后是美国贝莱德集团这个最大股东搞的鬼，反制贝莱德集团让其付出代价;1;0;1;9387;0.00010653030787258975
曝都会去看疯马秀表演虽然但是有没有人还记得日本还在进行核污水排放人家已经第一次排放结束了;0;5;5;9387;0.0005326515393629487
日本最早本月下旬开始第二次核污染水排放请问，就真的没有办法阻止日本排放核污水了吗？依旧继续抵制日本排放核污水;0;9;9;9387;0.0009587727708533077
参加疯马是为了加入光明会然后混到上层打断核污水排放从而挽留民族品牌花西子的日本源头工厂花西子花西子客服回应网传工厂在日本;1;2;3;9387;0.00031959092361776926
日本计划明年月底前排放轮核污水，占目前总量的月日，央视援引《读卖新闻》报道称，在对首轮核污水排放结果进行确认后，最快将于月上旬启动第二轮排放。根据计划，到明年月底，东电将对核污水进行轮排放。（视频来源小央视频）小央视频的微博视频;2;17;19;9387;0.0020240758495792053
老兵带你看世界直击一线情况太难了，首次日本核污染水近海氚浓度达检出下限东电承认是受排海影响网友：问问岸田怎么办，问问拜登怎么办，问问世卫组织怎么办？日本排放核污水的影响有多大品茶说酒的微博视频;-4;47;43;9387;0.004580803238521359
一早听到两件事都挺有意思。一是微软宣布月起停止对俄罗斯的所有服务。俄罗斯回应，将设立激活服务器，把微软收费版软件改为免费版向全世界发放。你单方面违约放弃规则我也放弃呗，这个思路不错，值得借鉴。二是国际黑客组织对日本核污水排放问题采取了攻击行动，导致日本多家核能相关网站遭到瘫痪。还将这些被瘫痪的网站替换为警告宣言，强调海洋是全人类的共同财产，批判日本政府的行为是对人类的犯罪。有报道说网络瘫痪导致日本核污水排放暂停，虽然还有待确认，但这一事件无疑让世界看到了另一种解决问题的途径。有一点我们可以相信，就是这个世界最终起作用的并不是强权，而是客观规律。;4;141;145;9387;0.015446894641525514
河南人怎么有脸嘲笑山东人的？我知道了苹果手机不是你偷来是你捡来圣母你吗丽姐姐的关节粉粉的查看图片布噜布噜瞄了一眼你主页确认你是日本排放核污水你都会一边辱中一边说核废水无毒的蠢必;0;94;94;9387;0.010013848940023436
日本化妆品两位大妈，日本公关费亿日元，请问你们收到了几亿啊，这么为日本洗。你家祖宗知道你们为日本洗吗？中国赚钱日本花，日本变现打回家？和我有什么关系？和我当然有关系了。就像为吸毒明星花钱，钱全变成子弹打在缉毒警察身上一样你不给日本花钱，日本那来的钱去建通道，将核污水运输到公里外的地方以及北赤道附近排放你花出去的钱全变成刀子扎在国人身上，却有大言不惭有什么关系？浅亦行的主页活得自在的主页;2;0;2;9387;0.0002130606157451795
围炉梁美仪辐射水流至香港威力减弱，吁日方邀各地化验增公信力香港“围炉”时政节目第集，香港城市大学海洋污染国家重点实验室主任梁美仪教授接受嘉宾主持公共政策顾问林致茵的访问，节目由月日起一连三日播出，梁美仪教授与林致茵在第二节的访问中，讨论日本排放核污水后，对周边地区的影响，以至对香港受影响的程度；另亦有讨论日本食物进口香港的食安问题。香港日本核污染水已排海吨日本将用亿日元处理核污染水负面信息历史会记住日本政府这一笔日本水产行业哀鸿遍野网页链接橙新聞的微博视频;1;4;5;9387;0.0005326515393629487
反咬一口，日本竟要求中方赔偿千亿日元就在全世界反对日本核污水排海的声浪一刚高过一浪时，日本政府提出了一项令人惊掉下巴的要求：要求中方赔偿千亿日元，作为对日本渔业和渔民因核污水排放计划而遭受的损失的补偿。日本政府声称中方的水产品禁令违反了世贸组织的规则，但这一主张同样缺乏坚实的法律依据。世贸组织规则允许成员国在特定情况下采取限制贸易的措施，尤其是在涉及公共安全和环境保护的情况下。我国曾表示，其禁令是为了保护公民健康和安全，因此符合国际贸易规则。所以怼哥不得不问：要脸不、要脸不、要脸不？;3;13;16;9387;0.001704484925961436
谁在给东电“撑腰”？誰在給東電撐腰？背靠日本财阀，垄断日本约三分之一的电力供应，年还获日本政府注资万亿日元东电到底什么来头？东电昨天宣布完成第一次核污水排海，总计排放量达吨，最快本月下旬开始第二次排放。大公报记者核查资料发现，日本政府是东电的第一股东，持股逾半。这意味着，东电执意将核污水排入大海的决定，体现的是日本政府的决策。东电还是日本企业政治捐款的典范，福岛第一核电站发生事故前，东电管理层每年政治捐款总额约万日元，大部分流向自民党誰在給東電撐腰？;3;41;44;9387;0.004687333546393949
韩水产商贩称生意大跌成韩国海洋水产部月日表示，日本排放核污水后，韩国三大连锁超市消费额反呈上升趋势，水产方面销售也并没有受到很大影响。然而效果是否真如韩国政府的预期？凤凰记者来到首尔鹭梁津水产市场实地探访，有水产品商贩表示，销售额大概减到了一半，“日本核污水排海后，客人们的想法再怎么说也是会受到影响，排海之前跟排海之后差别很大。”他形容韩国人民及商贩都不能容忍日本排放核污水的行为，感到无奈，市面对水产品需求量大幅下降，严重打击了业界生计。（凤凰卫视）凤凰卫视的微博视频;2;3;5;9387;0.0005326515393629487
唐诗咏超话唐詩詠無懼核污水照去大阪曾爆有留意日本物業離巢後疑想移居？唐诗咏年月日歲視后唐詩詠（）去年底約滿離巢，與無綫（）結束近年的賓主關係。回復自由身的如今放慢腳步，不時相約朋友聚會，又四圍飛去旅行，享受寫意人生，十分識嘆。展开;2;16;18;9387;0.0019175455417066154
老兵带你看世界跟着凤凰卫视直击一线情况李在明绝食第天，极度虚弱，几乎只能躺卧，靠水和盐维持生命韩另一在野代表探望网友：你是韩国最帅的男人日本排放核污水的影响有多大品茶说酒的微博视频;46;253;299;9387;0.03185256205390433
今天日本第一轮核污水就排放完了不知道以后会怎么样，今天早起拉粑粑的时候，看到小日子还修了管道，距离他们近海公里才开始排，真他娘的大聪明;0;1;1;9387;0.00010653030787258975
说真话知真相超话韩国反核污水老头日水和盐保持身体能量，日再躺床真出事小尹和日本怎么收场网友：地球之大，反对核污水排放第一人，必须说真话知真相星球之音的微博视频;1;13;14;9387;0.0014914243102162564
小日子排放核污水的热度是越来越低了，说明几百亿公关起到作用了，看到很多视频发现国外绝大多数的人都还都不知道这件事，跟地球和海洋里的生物一样无助又无能为力日本核污水日本第一批核污水排放吨日本核污染水排海天后海洋啥样;3;1;4;9387;0.000426121231490359
就在日本完成核污水第一阶段排海计划之际，网上突然出现了一个视频，核辐射监测显示：大海其实早就被严重核污染了，这就是欧洲国家不反对日本排放核污水的原因。必须高度警惕日本政府亿日元公关费正在为日本进一步排放核污水做无害化辩护：核污水排海影响不了食品安全，人们一直都在吃着海鲜;1;2;3;9387;0.00031959092361776926
日本网民：往海里排放核污水，他们有的人选择赞成，的人选择反对。;82;175;257;9387;0.027378289123255566
瞄了一眼你主页确认你是日本排放核污水你都会一边辱中一边说核废水无毒的蠢必;4;94;98;9387;0.010439970171513796
日本排放核污水，为何西方国家集体沉默，原因在这儿，它们都是一条水沟里的臭虫，彼此彼此，所以也就默许鬼子祸害人类。丶木子井的微博视频;1;14;15;9387;0.0015979546180888463
为什么最近感觉各种乱七八糟的病毒都开始冒出来，而且日本又排放核污水，都不知道能活到多久后。唉，能活一天是一天吧，对自己好一点，能满足自己的就尽量去满足自己吧。现在开始每天上班坚持戴口罩，我还不想太快被传染那些乱七八糟的病毒。;2;2;4;9387;0.000426121231490359
说真话知真相超话月日，韩国女市民为支持李在明绝食国会门口削发，网友：日本排放核污水就是发动核战争，就是污染海洋，破坏人类共同生活的家园。坚决反对日本排放核污水说真话知真相网页链接;-3;102;99;9387;0.010546500479386385
日本驻华大使馆：日本排放核污染水，除了美国支持我们，英国也支持日本核污水排海;38;360;398;9387;0.04239906253329072
我们也敦促小日子自己把核废水喝了一玄少一它以为暂时停排咱就又又又可以上当了蓝色夜晚的记忆中国将继续敦促日本终止排放核污水;1;985;986;9387;0.1050388835623735
开心周报的视频年高中生上大分，写歌为大海发声日本，这才是该有的样子。日本已排放超吨核污染水坚决抵制日本排放核污水;1;0;1;9387;0.00010653030787258975
日本将捕捞到的首批数万吨新鲜的三文鱼，计划运往挪威销售。挪威是欧洲国家，正好在月初解除了对日本水产品的禁令，而日本则月日开始，向海洋排放核污水。挪威本国有足够的水产品供应，为什么还要进口日本的水产品呢？;8;30;38;9387;0.004048151699158411
日本第二次核污水排海最早月下旬开始日本首轮核污水排海累计立方米据央视新闻援引日本《产经新闻》报道，日本东京电力公司今天将完成福岛第一核电站核污染水首次约吨的海洋排放。预计第二次排放最早将于本月下旬开始。日本首轮核污水排海结束据日媒报道，东京电力公司尚未明确第二次排放的时间。“在首次排放后，我们将对稀释和排放设备进行全面检查，并回顾首次排放的操作记录等。”东京电力公司此前的一份声明称，当地时间月日，一条转移核污染水的管线发出泄漏警报，但没有检测到实际泄漏。据中新网报道，由于排污管道内会残留少量核污染水，东京电力公司在月日使用工业用水对排污管道进行了全面清洗，随后开始着手第二批次排污。按计划，年内，日本总共将分次排出万吨核污染水。有数据显示，在正式排污开始前，核污染水已存到了万吨，要把核污染水全部排完，上述操作还将循环多次，整个排污过程至少需要年。;24;51;75;9387;0.00798977309044423
被核污染水浸泡的世界超话日本已排放核污水吨，还在继续。;1;1;2;9387;0.0002130606157451795
华为浏览器日本完成首次核污水排海，约吨二轮排放时间是网页链接;1;2;3;9387;0.00031959092361776926
花西子客服回应网传工厂在日本讲道理，“花西子”这个名字就感觉很日式，是不是因为最近日本核污水排放启动，所以不想和日本有任何瓜葛了那么之前的视频就是虚假宣传了哦;-1;11;10;9387;0.0010653030787258974
視后唐詩詠自去年約滿離巢後，無約一身輕嘅佢生活過得相當寫意，並不時喺社交網分享周遊列國嘅靚相，而最近頻頻去日本玩嘅佢，其實早於年就透露過想喺日本置業。雖然近期日本排放核污水話題喺全球各地掀起熱話，唔少港人都選擇改去其他地方旅行，不過唐詩詠睇嚟就未驚過，近日唔止現身大阪街頭，畀網友野生捕捉嘅佢，仲相當親民咁大方合照。只見打扮低調樸素嘅佢，雖然着灰襯牛仔褲，不過即使頭髮放晒落嚟，戴住副黑超都仍然星味濃，白滑美肌更係一啲都睇唔出佢已經歲。;4;13;17;9387;0.0018110152338340257
吃完饭去上课结果突然下雨了本来想着又可以淋雨玩了突然想起日本排放核污水了要少淋雨我真的是恨死了;3;9;12;9387;0.001278363694471077
日本岁男子性侵岁女子致死就说小本干不出来正常的人的事吧，前有排放核污水，后有普通人干这事，吐没有人性，的请呼吸岁本应该颐养天年的;7;377;384;9387;0.040907638223074465
所以日本核污水的热度是过去了吗？那群狗还在不停的排放呢;2;0;2;9387;0.0002130606157451795
第一轮核污水计划在月底排放，现在有越来越多的主播在传播歪理，鼓励大家去吃海鲜，他们的良心这么快就被核污水污染了吗？日本核废水日本民众就核污水排海提起集体诉讼;3;9;12;9387;0.001278363694471077
日本核污水第一次排海今日将结束一个热知识：日本有办法解决核废水，但是成本太高不舍得花钱冷知识处理排放核污水的舆论的钱已经超过了处理核污水的钱;1;7;8;9387;0.000852242462980718
日本东京电力公司今天将完成福岛第一核电站核污染水首次约吨的海洋排放。第二次核污水排海时间计划在本月下旬，估计第二次排放量可能会更大，第一次得逞了、第二次就更加肆无忌惮了，况且有美国和韩国大力支持，日本会抓紧这个机会。;1;3;4;9387;0.000426121231490359
李佳琦超话日本排放核污水李佳琦开始抵制日货赔付违约金没人说现在针对一些黑粉说了不合时宜的话就被大家对号入座围起来骂，甚至有的根本没看过他直播不知他产品如何售后如何扪心自问网暴他人对自己本身有什么好处，说白了也不过是各取所需他为大家争取最好的权益我们也图得他比别处便宜，积点口德吧;4;40;44;9387;0.004687333546393949
日本核污水第一次排海今日将结束，核污染水首次排放约吨。东电称最早月下旬开始第二次排放，台风“鸳鸯”侵袭日，是否影响排海受关注。日本今日结束第一次核污水排海日本核污染水第二次排海或月下旬开始日本第一批核污水共吨天桥融媒的微博视频;15;8;23;9387;0.002450197081069564
名日本民众起诉日本政府及东电近日，来自日本福岛县、宫城县等地的约名民众日向福岛地方法院起诉日本中央政府和东京电力公司，要求其叫停月启动的福岛第一核电站核污水排海计划。原告方律师团称，这是日本全国首起有关叫停核污水排海的诉讼。起诉书称，原告认为核污水排海侵犯了日本民众平稳生活的权利，渔业从业者维系生计面临困难，因此要求日本原子能规制委员会取消排海许可，禁止东电继续将核污水排放入海。（澎湃新闻）麦穗财经的微博视频;8;12;20;9387;0.002130606157451795
日本核污染水首次排海今日结束不要让日本排放核污水热度降下去;1;1;2;9387;0.0002130606157451795
日本首次核污染水排海日结束据《产经新闻》日报道，日本东京电力公司当天将完成福岛第一核电站核污染水首次约吨的海洋排放。预计第二次排放最早将于本月下旬开始。日本第批核污水排海或月底开始（央视新闻客户端）;1;3;4;9387;0.000426121231490359
日本欧洲中国日本核污水几千吨已经排放了，欧美为什么不反对？因为他们早就排放了，大西洋边上的挪威海，美国的墨西哥湾，美国在太平洋岛屿上的星星点点，日本早在核污水排放之前就红彤彤了，只有中国海域，干干净净;1;0;1;9387;0.00010653030787258975
日本核污染水首次排海今日结束日本核污染水首次排海今日结束。首次排放大约排了吨，第次排放可能在月下旬。日本核污水排海祸害的不仅仅是全球，首先祸害的是它自己。日本已经连健康和经济都同时丢掉了。云中漫步艺术画廊超话云中漫步原创诗画的微博视频;2;7;9;9387;0.0009587727708533077
日本排放核污水不买一分日货超话反对日货拒绝日货;1;0;1;9387;0.00010653030787258975
你们没人发现吗？最近出现的事件一连接着一个，日本排放核污水、和的、疯马秀、进而李佳琦花西子事件，真的一个接着一个，但是来一个我们就会自动把目光放在新的热点之上，旧的热点会慢慢被忽略。;2;11;13;9387;0.0013848940023436667
日本核污染水首次排海今日结束日本首次排海结束了，日本已排放超吨核污染水，从日本核污水开始排放到现在，大家有没有注意点到一个点以前那些整天嚷嚷着要搞环保、动保的，几乎各个鸦雀无声。网络上反对的声量越大，他们拿到的封口费就越大，这是一种压力，唯一化解的方式就是，得加钱，需要大家共同发声，拒绝麻木，不做冷漠的看客能传播信息的尽量传播，让国内外更多的人知道日本的罪证;4;51;55;9387;0.005859166932992437
日本核污染水首次排海今日结束联合国人权理事会：将重点讨论日本排放核污染水联合国第届人权理事会将于月日到月日在日内瓦万国宫召开，本次会议主席回答凤凰卫视记者提问时透露，由于日本排放福岛核污水事件在全球舆论不断发酵，引起人权领域强烈关注，本届会议的与会各国将着重讨论相关问题。而在此之前，第届会议有毒核废料特别报告、用水安全报告，第届环境和食物问题特别报告，第届健康问题特别报告，以及“日本人权机制普遍定期审议”中都数次谴责了核污水排放。（凤凰卫视张博谛日内瓦报道）凤凰卫视的微博视频;8;59;67;9387;0.007137530627463513
日本核污染水首次排海今日结束联合国人权理事会：将重点讨论日本排放核污染水联合国第届人权理事会将于月日到月日在日内瓦万国宫召开，本次会议主席回答凤凰卫视记者提问时透露，由于日本排放福岛核污水事件在全球舆论不断发酵，引起人权领域强烈关注，本届会议的与会各国将着重讨论相展开;4;59;63;9387;0.006711409395973154
日本首相岸田文雄表示很多国家赞扬他们排放核污水透明、安全的，并表示继续敦促中国结束对日本海鲜进口的禁令日本核污染水首次排海今日结束墨染诗婳的微博视频;-26;324;298;9387;0.031746031746031744
联合国将重点讨论日本核污水排海，希望你们屁股坐正了蛟龙军事联合国人权理事会：将重点讨论日本排放核污染水网友：讨论一下，还是，做出点成绩出来难舍深蓝的微博视频;176;1051;1227;9387;0.13071268775966763
东北亚共同社：福岛、宫城、岩手、茨城、千叶、东京、新潟等地居民就核污水排海起诉日本政府和东电，并要求日本原子能规制委员会取消排海许可，禁止东电公司继续将核污染水排放入海。起诉书称，“实施故意污染环境的行为是违法行为，不能容许”。律师团称，“核污水排海是过失造成事故之后故意实施的新加害行为”。;4;37;41;9387;0.0043677426227761796
日本核污染水首次排海今日结束九月下旬还要第二次排放核污水？爆富吧，让海水倒灌回去，让小日本自己喝了;26;1460;1486;9387;0.15830403749866837
花西子我一直以为是国货来着，因为设计都比较古风。没想到工厂在日本，我了个去。日本排放核污水可不敢用它的产品了。;1;0;1;9387;0.00010653030787258975
日本核污染水首次排海今日结束这是小日子核污水排放的第天，已排放超吨核污染水，月下旬还有第二轮。太平洋在哭泣;0;74;74;9387;0.007883242782571642
日本核污水最早月下旬开始第二次排放日本核污水第一次排海今日将结束据国际时讯报道：据日本产经新闻报道，“东京电力公司今天将完成福岛第一核电站核污染水首次约吨的海洋排放”。东电称，在进行相关确认和设备检查后，最早将于本月下旬开始第二次排放。;1;0;1;9387;0.00010653030787258975
日本核污染水首次排海今日结束日媒宣布，福岛核污水的首轮排放已于今天结束，本轮被排入大海的核污水共计吨;73;992;1065;9387;0.11345477788430809
最新发布：日本今天将完成第一轮核污水排海，共计约吨第二轮排放安排在本月下旬;9;20;29;9387;0.0030893789283051028
日本核污水排海“地球之殇”背景北京时间月日中午点（日本当地时间点），日本福岛第一核电站启动核污染水排海，预估排放时间将长达年，从直播实时画面可以看到，排放现场海水已呈现出两种颜色。重建人与自然平衡保护海洋生态环境人人公益节为爱捐赠，请点击展开;1;1;2;9387;0.0002130606157451795
日本核污染水首次排海今日结束日本核污水最早月下旬开始第二次排放据日本产经新闻报道，“东京电力公司今天将完成福岛第一核电站核污染水首次约吨的海洋排放”。东电称，在进行相关确认和设备检查后，最早将于本月下旬开始第二次排放。;2;97;99;9387;0.010546500479386385
日本核污染水首次排海今日结束日本核污染水第二次排海或月下旬开始日本至少还要排放核污水年，不要放弃抗议啊;1;1;2;9387;0.0002130606157451795
日本核污水第一次排海今天结束据国际时讯援引日本产经新闻报道，“东京电力公司今天将完成福岛第一核电站核污染水首次约吨的海洋排放”。东电称，在进行相关确认和设备检查后，最早将于本月下旬开始第二次排放。人民视频的微博视频;7;47;54;9387;0.005752636625119847
“中国的二氧化碳排放量占全球的成”又想以环保之名限制中国发展了杨哥逐日日本的核污水排放量世界第一。中国今年新能源装机首次超过火电，增加绿电的目标上一直在前进，倒是有些国家在核污水排海。;1;118;119;9387;0.01267710663683818
日本核污染水首次排海今日结束没什么可多说的。我还是那句话，能抵制的继续抵制。勿以善小而不为。抵制对日本来说，其实是很疼的。不然的话，也不会我们一停止进口日本产品，岸田文雄就急得滋哇乱叫，还要到去投诉我们。我们或许阻止不了日本排放核污水，但我们能做的却是让日本感觉到疼。这件事情本身很有意义。;18;740;758;9387;0.08074997336742303
日本核污染水首次排海今日结束核污水首次排海就排放了吨，不知道该说啥了，小日本早日毁灭。;26;591;617;9387;0.06572919995738788
日本核污染水首次排海今日结束这是日本核污水排放的第天，日本已排放超吨核污染水，月下旬还有第二轮，我们一起顶顶热度，要坚持抵制日货，而不是越到后面越消极，一个人的声音很小，需要大家共同发声，拒绝麻木，不做冷漠的看客能传播信息的尽量传播，让国内外更多的人知道日本的罪证;34;1703;1737;9387;0.1850431447746884
日本核污水第一次排海今天结束据日本产经新闻报道，“东京电力公司今天将完成福岛第一核电站核污染水首次约吨的海洋排放”。东电称，在进行相关确认和设备检查后，最早将于本月下旬开始第二次排放。（国际时讯）;5;11;16;9387;0.001704484925961436
得加钱日本有个街头采访，问一个年轻人：你怎么不反对核污水排放。他说：反对也没用。问：那你还吃海鲜么。他说：吃。问：那你不怕会的癌么。他说：不怕。问：那你不为孩子着想么。他说：我不生孩子。;1;7;8;9387;0.000852242462980718
日本核污水第一次排海今天结束最早本月下旬开始第二次排放据日本产经新闻报道，“东京电力公司今天将完成福岛第一核电站核污染水首次约吨的海洋排放”。东电称，在进行相关确认和设备检查后，最早将于本月下旬开始第二次排放。日本核污染水首次排海今日结束;8;31;39;9387;0.004154682007031001
日本本月下旬或继续排放核污水日本核污染水首次排海今日结束据日本产经新闻报道，“东京电力公司今天将完成福岛第一核电站核污染水首次约吨的海洋排放”。东电称，在进行相关确认和设备检查后，最早将于本月下旬开始第二次排放。（国际时讯）;10;10;20;9387;0.002130606157451795
日本核污水最早月下旬开始第二次排放日本核污水第一次排海今日将结束据国际时讯报道：据日本产经新闻报道，“东京电力公司今天将完成福岛第一核电站核污染水首次约吨的海洋排放”。东电称，在进行相关确认和设备检查后，最早将于本月下旬开始第二次排放。日本核污染水首次排海今日结束;149;1129;1278;9387;0.1361457334611697
喝水爱用碗坚决抵制日本排放核污水抵制;1;9385;9386;9387;0.9998934696921274
日本排放核污水第十九天还来第二波的意思就是，从号开始，清理管道残留，还排，但数量没那么多。等到九月底继续大量公开排;1;3831;3832;9387;0.40822413976776395
唐城景区就被指区别对待游客致歉不懂？都这个时候了，日本排放核污水，美国挑起战争，西方国家对中国各种挑衅，还在为几个外国人让众多国人等待？在干什么？你是活在大清？大可不必，有些人就是脑子进水了;2;12;14;9387;0.0014914243102162564
小八嘎别想混淆视听日本排放核污水核废水离谱微博计划娱乐转转乐的微博视频;4;40;44;9387;0.004687333546393949
竞然看不到几个明星，专家，有影响力的人来抗制日本的核污水排海，确实是中国的可悲，所有中国人应该站出来，一起为自己的健康，我们为子子孙孙做点事，为整个人类做点事，不要等到海带都不能吃了，然后才开始后悔没有当初只是冷眼旁观。喝水爱用碗坚决抵制日本排放核污水抵制;2;9385;9387;9387;1.0
脸都不要了，韩高铁投放“洗白”核污水手册，韩交通部长忙撇清关系日本排放核污水，全球各地区都响起讨伐日本的声音。然而，偏偏有一个国家的政府反其道而行之。它就是韩国政府，它不仅不谴责日本，甚至还主动帮日本做宣传，就像这次，它就花费了亿韩元为日本开脱。展开;23;24;47;9387;0.005006924470011718
換個角度思考。核污水核废水商业思维日本已排放超吨核污染水财商林子豪虎牙的微博视频;5;13;18;9387;0.0019175455417066154
在小看到的，小日本鬼子真的没脸没皮倭国赶紧灭亡日本排放核污水;1;1;2;9387;0.0002130606157451795
日本核污染水核污水排放周海水一片漆黑核污水排放影响天呐日本的公关费看来是给有到新浪了，啧啧;2;7;9;9387;0.0009587727708533077
俄罗斯：若日本继续排放核污水，不排除动武的可能性把核污水排到其它国家，核污水本身就是武器;19;642;661;9387;0.07041653350378183
俄罗斯：若日本继续排放核污水，不排除动武的可能性把核污水排到其它国家，核污水本身就是武器桂哥猎手的微博视频;5;14;19;9387;0.0020240758495792053
抗日坚决抵制日本排放核污水抵制日货大半夜的被小日子恶心得睡不着，真的被气哭了，别让我看到日本人，不然我怕我忍不住热度别降国是千万家，有国才有家，国事不担心，那还担心什么;1;0;1;9387;0.00010653030787258975
我一三五谴责日本排放核污水，二四六请求大英博物馆归还文物，周日痛骂疯马秀;1;8;9;9387;0.0009587727708533077
陈粒超话这好比前有日本排放核污水后有删帖控超话这波，;2;2;4;9387;0.000426121231490359
彭博社：伊曼纽尔的言论违背美国外交官一贯的做法。月底，它也因到福岛吃海鲜以示支持日本排放核污水入海，在中国网络引起热评。评一句：它是不是被中国网友骂得气急败坏，所以语无伦次了。也有可能是吃了核食思维不正常了。黄媒不会说的真相;13;63;76;9387;0.008096303398316821
排放核废水已经好多天了可现在某些平台的热度越来越小了这就是想要的效果大家都在追逐下一个热点所以排放核污水这个事情已经用钱压下去了求转发谢谢反对日本排放未处理核污水超话;1;1;2;9387;0.0002130606157451795
日本请停止排放核污水;1;1;2;9387;0.0002130606157451795
今年癸卯年，水在卯中傷，已經應驗在日本核廢水排放。水，受傷了。癸水長生在卯，自做長生，今年又應什麼事呢？癸水為雨水，黑水，帶色的水，污水，廢水，酒水等。只有戊土可以化合化解。八字命中有戊土的人有福了，化兇為吉。沒有戊土，長期供養土地公的也有福。祈福，动工，嫁娶等择日最好别展开;1;2;3;9387;0.00031959092361776926
说真话知真相超话绝食第十天都报道他饿趴，韩国月日李在明为日本排放核污水绝食就在大街上星球之音的微博视频;13;288;301;9387;0.03206562266964952
马英九执政时期，台湾一干艺人在民进党煽动下发起反对核电站的运动，结果现在日本排放核污水，他们却悄无声息了日本核污水襄阳盛世唐城景区发布致歉信;28;378;406;9387;0.04325130499627144
正规三概念是讽刺日本排放核污水还有劝告大英博物馆无条件归还中国文物最后是带丫丫回家;1;572;573;9387;0.06104186641099393
盐小日本核污水排海第天，第一批排放今天下午结束。祈祷生灵安好;1;69;70;9387;0.007457121551081283
我发表了头条文章《我对于日本排放核污水的看法。》;2;3;5;9387;0.0005326515393629487
老兵带你看世界直击日本当局强排核污水后日民众的抗议日本多地民众举行反核污染水排海抗议活动，日本媒体很少报道网友：为什么呢？因为怕更多的人反对日本排放核污水的影响有多大品茶说酒的微博视频;5;30;35;9387;0.0037285607755406414
弯弯女星林志玲，曾在支持民进党反对核电厂时高呼：我是人，我反核。现在日本大肆排放核污水，她和许多弯弯却保持沉默。不知他们现在如何看待自己的属性。;118;1198;1316;9387;0.1401938851603281
岸田称要求中方撤销进口管制措施如果预制菜进了你孩子的学校谁在炒作只有中国反对日本排放核污水日本密集收购中国中药企业每一代人都有属于自己的抗日任务小日本亡我中华之心不死小时候：大人为什么对小日本这么恨我觉得还好吧千人千面无辜的人民不等于从前的日本现在：抗日坚定展开;1;2;3;9387;0.00031959092361776926
老兵带你看世界直击一线情况尹锡悦不惜亲自带头吃海鲜赖岳谦：韩国有一个“助日总统”网友：他吃的肯定不是福岛的海鲜啊保不齐是从挪威空运过来的呢日本排放核污水的影响有多大品茶说酒的微博视频;5;23;28;9387;0.002982848620432513
羽生结弦冰演超话纪念最后一次买疯批日本的货冷知识：居里夫人的笔记本还要辐射年柚子结婚的报纸是疯批日本排放核污水前买的代购还送了我一包喜糖;7;26;33;9387;0.003515500159795462
据日本东京新闻报道，福岛东京电力公司的计算机系统因黑客攻击而瘫痪，日本国内核废水排入大海目前已暂停。与此同时，日本多家核能网站遭到攻击。更令人震惊的是，这个黑客组织将多个遭受攻击的核能网站转化为该黑客团队的警告声明。他们坚定地强调，海洋是全人类的共同财产。谴责日本政府的行为展开;1;13;14;9387;0.0014914243102162564
又没有热度了，抵制日本在次排放核污水啊，海洋和海洋生物替他们悲哀日本核污水坚决抵制日本排放核污水;1;1;2;9387;0.0002130606157451795
中国科学技术大学物理学教授朱士尧：谈日本核污水排放，核污水怎么来的，以后又将怎样核污水微博计划泉州那些事儿的微博视频;4;48;52;9387;0.005539576009374667
老兵带你看世界听郭正亮讲日本核污水排到美国之后日本排放的核污染水，或许先到阿拉斯加郭正亮：很有兴趣看他们渔民的反应网友：阿拉斯加的渔民知道吗？日本排放核污水的影响有多大;1;49;50;9387;0.005326515393629488
独立思想者榫韵聊宇日本已排放核污水吨，还在继续。专家集体失声了，可能比烧秸秆等等轻的多吧？联合国哑雀，数国哑雀怎么办？;53;1115;1168;9387;0.12442739959518483
欢迎大家今晚来看直播直播预告日本核污水排海，该如何理解？如何应对？直播预告日本核污水排海，该如何理解？如何应对？原创袁岚峰风云之声发表于安徽图片图片年月日，日本政府正式启动计划了两年多的福岛核污染水排海。这在国际上造成了巨大的争论，甚至中国国内舆论也产生了撕裂。一方面，中国外交部表示严正抗议，认为福岛核污染水排海计划的正当性、合法性、安全性一直受到国际社会质疑。另一方面，日本政府拉到了一把“尚方宝剑”：国际原子能机构（）出了个报告，认为日本排放的核污水是安全的。那么，我们对日本的行为究竟该不该反对？在争论的同时，老百姓的生活和心理已经立竿见影地受到了影响，有人担心中国渔业受到冲击，有人担心核辐射开始抢盐。我们应该如何理解这些问题？在个人和国家的层面，我们应该如何应对？直播主持人：袁岚峰中国科学技术大学合肥微尺度物质科学国家研究中心副研究员，中国科学技术大学科技传播系副主任，中国科学院科学传播研究中心副主任图片专家嘉宾：陈志中国科学技术大学核科学技术学院副教授，中国辐射防护学会常务理事，生态环境部电离辐射环评专家，第十三届国际辐射屏蔽大会技术委员会委员，美国核学会辐射防护与屏蔽分会第届技术委员会委员图片黄方中国科学技术大学地球和空间科学学院教授，中国矿物岩石地球化学学会第八、九届同位素地球化学专业委员会副主任图片宿东君中国电子企业协会副会长，中国国际贸易促进委员会建设行业分会名誉副会长图片一，在基本科学原理上，该如何理解日本核污水？它是如何产生的？有什么成分？可能有什么危害？跟正常运行的核电站废水有什么区别？二，在处理方法上，该如何理解的报告？除了排海之外，还有哪些可选的处理方案？为什么日本选择了最便宜、最简单的排海方案？国际上除了之外，其他机构和国家对日本有什么看法？有人说，全世界只有中国反对日本排海，这是真的吗？三，中国老百姓的生活会受到什么样的影响？日本的水产该不该禁？中国的水产还敢不敢吃了？用不用去抢盐？四，在国家的层面，中国应该如何应对？在政治、经济、法律、外交等层面，我们有哪些办法？这件事对全世界、全人类会有什么样的长远影响？网络直播平台与账号包括：百度百科，百家号，袁岚峰；微博，中科大胡不归；视频号，袁岚峰；腾讯新闻，风云之声；哔哩哔哩，袁岚峰；抖音，今日头条，西瓜视频，袁岚峰中科院科学传播研究中心；知乎，袁岚峰；科大硅谷；蔻享学术。月日，不见不散;3;16;19;9387;0.0020240758495792053
没见过这么无耻的民族气死了真的气死了日本日本排放核污水营销号大赏颜汽水的夏天的微博视频;1;1;2;9387;0.0002130606157451795
美国都退出巴黎气候协议了，日本都明目张胆排放核污水了，我们还在纠结该不该焚烧秸秆沧州这点事儿的微博视频;7;23;30;9387;0.0031959092361776927
亿日元处理舆论，处理核废水只要亿日元日本日本排放核污水丧尽天良，每日娱乐综合推送的微博视频;1;11;12;9387;0.001278363694471077
很可怕，日本排放核污水这事儿没有了热搜。人至贱则无敌？？大海仍在悲鸣;1;7;8;9387;0.000852242462980718
日本核污水他们排放的不是核废水，是核污水不要无耻的以为公关费砸得够多就能掩盖日本排放核污水的事实，我们会一直记录日本的犯罪事实;2;10;12;9387;0.001278363694471077
老兵带你看世界听郭正亮讲日本核污水排到美国之后日本排放的核污染水，或许先到阿拉斯加郭正亮：很有兴趣看他们渔民的反应网友：阿拉斯加的渔民知道吗？日本排放核污水的影响有多大品茶说酒的微博视频;11;49;60;9387;0.006391818472355385
坚决抵制日本排放核污水;1;6813;6814;9387;0.7258975178438266
不吃鱼翅的姚明，有没有反对日本排放核污水？;1;2;3;9387;0.00031959092361776926
安重根和李在明两大韩国义士，一个断指盟誓，成功刺杀了日本首相伊藤博文，另一个绝食七天抗议日本核污水排放抗日英雄武统超话武力统一的微博视频;5;145;150;9387;0.01597954618088846
日本已经排放了吨核污水，第二次核污水排放计划要在九月底排放，海里的生物和沿海的普通人民唯一的希望就是能活下去，生存的需求都是一种奢望日本核废水;1;6;7;9387;0.0007457121551081282
那么多未曾见过的海洋真的不愿意去想象，有一天他们会变成黑色的，散发着恶臭的存在海洋日本排放核污水快乐的猩球的微博视频;1;2;3;9387;0.00031959092361776926
多种有害物质只公布一项？国际原子能机构首次发布了日本福岛第一核电站排放核污水后的独立报告，该机构的报告显示，日本排放后的海水氚浓度低于安全极限，此外，国际原子能机构还对外强调，该机构在日本福岛第一核电站方圆约公里内的多个地点进行了海水样本采样，检测结果与日本方面此前发布的报告展开;1;120;121;9387;0.01289016725258336
热度上去拒绝麻木，不做冷漠的看客正如鲁迅先生说的：“你可以躲在角落里沉默，但是不要诋毁和嘲笑比你勇敢的人，因为他们争取到的光明也许会照耀到你”日本核废水坚决抵制日本排放核污水抵制日货勿伤同胞;53;1382;1435;9387;0.1528709917971663
请大英博物馆无常归还偷窃中国的文物日本排放核污水美国居然同意，唉，资本中国男孩保护中国女孩对比韩国来说，日本都看顺眼了。日本真是在哪个时代都要干一些丧尽天良的事情。日本排放核污水我还能见到你吗，海在悲鸣。;-1;13;12;9387;0.001278363694471077
核污水排放看法读万卷书，行万里路，人们都知道书是人类最好的朋友。喜欢阅读，最喜欢读汤小团，已经在读第遍了，可小日本的核污水排放却深深地触动了我，发现自己阅读量不够，从各种媒体的新闻报道中了解到，日本的国土虽大但资源贫乏，为了降低把核污水消除的成本，日本选择把核污水排入太平洋，还有一点，在环球时报中，我了解到日本排放核污水第天就发生了两次级大地震和一次“龙吸水”（龙卷风）。把第波核污水卷回了日本福岛。在日本总统试吃了福岛海鲜后，在个小时之内就进入了重症病房洗胃。今天是月号，下午，第批核废水将会排完。排完后将会用工业水来洗管道，避免核污水残留。俄罗斯说：如果日本不停止排放核污水，将会使用“武力”解决。最后我想对日本说：“你们若会不停排放，将会接受“全球”人民的”正义裁决”;1;0;1;9387;0.00010653030787258975
德国比日本德国踢日本怎么不捂个嘴抗议日本核污水排放？反正德国队现在心思不在足球上，不如整个大的。德国足协花亿日元请日本比赛;9;208;217;9387;0.023117076808351976
日本核污水日本排放核污水为什么没热度了，真被洗了？搜日本出来的居然是核废水，微博你有心吗你，你也是小日本吗;1;5;6;9387;0.0006391818472355385
今世迷缘恶劣天气致日本至少人遇难他们排放核污水入海，现在遭遇台风，正好把污染的海水倒灌到他们陆地上。让他们自己享受核餐;1;11;12;9387;0.001278363694471077
强烈要求微信视频号关闭直播间里日本带货主播号每天只要一打开微信，里面的直播推送就是在日本，日本商贸等等闯进眼球，让人烦不胜烦自从日本排放核污水以后，想到那些海洋的生灵，内心疼痛无以言表，对日本这两个字深恶痛绝我坚决不用日本的任何产品，也不需去了解该国的生活文化但微信己经是我生活的一部分，是传递信息的渠道，可每天打开就看到直播推送的日本，我个人认为对于中国人来说，这是很危险的提示，日本在以直播引流的方式潜以默化的熏陶我们接受，认可日货在此我申明，我是中国人，我坚决不用日本任何产品，因为一直被迫接受带货日本主播，我不得不关闭了微信直播，强烈要求微信视频号关闭有关日本任何话题的直播号，还我国人微信之清净;0;3;3;9387;0.00031959092361776926
日本核污水热度极低持续排放的核污水从欧洲兜转一圈到国内的换标签日本海产品日本原料的预制菜超高公关费反咬一口的小日本新仇旧恨就应该要有极高的反日情绪;-76;1;-75;9387;-0.00798977309044423
关于日本排放核污水这一事我认为（仅我自己想法）群众不要被激怒，相信国家，相信党的领导，现在不单单是日本排放核污水这件小事，美方默认是因为美方想利用日本打倒中国，美方想独大他最大的威胁就是中国，他不会让日本人排放很长时间的核污水，他不会任由和污水蔓延到自己的境地，相信国家的判断，群众不要给国家压力，这时候我们武器反抗，反而陷入了美方的陷阱。一定要相信国家。不要觉得国家言语上的反对不作为。（仅为我自己观点）;0;1;1;9387;0.00010653030787258975
核污水排放没人关心了吗这才过了多久热度就没了现在的热度都在关心某女星去跳舞，就很心寒坚决抵制日货从我做起日本核污染水排海正式开始研究称日本核污水排海天到达中国核污水排放周海水一片漆黑;136;2710;2846;9387;0.30318525620539044
前几天和两个朋友聊日本排放核污水这个事儿。说咱们中国这边虽然网上喊得厉害，但是市场上没啥反应，海鲜还是有的卖有的吃。韩国那面怎么那么紧张？又是市场没人又是上街游行的？说还是韩国人“有刚儿”。我说那是因为韩国有在野党而已，给执政党上眼药呗。说是不是这个核污水真没什么事儿？日本人不至于那么二逼吧？明知道有污染还往海里排，他们自己不是第一个被污染的？我说那可真不一定，你不能按中国人的思维去看日本人。说，对，日本人那是人吗？那都是畜生。我说以我这些年对日本人的了解，一般来说，他们面对突发问题，第一反应都是猫盖屎，不想长远后果，先想怎么把自己的责任搞得最小，撒谎撩屁，欺下瞒上。如果事情严重，就会把越来越多的人拖进来，责任人越来越多，人越多就人人不想负责，只能一拖再拖，拖不下去就搞一个自欺欺人的方案。比如这个核污水排放问题，可能会需要检测很多项，他们也都知道要检测很多项，但他们可以做到都装作不知道，但只要有一个人提出来检测了某几项，结论是安全的，可以排放，他们就敢拍板集体拍板，谁也不用负责。是做生意的，是运动员，我是打工的。;1;5;6;9387;0.0006391818472355385
不知道是不是因为小日本排放核污水产生的心理影响，感觉扇贝和青口都不鲜甜了;0;1;1;9387;0.00010653030787258975
日本核污水排放后总觉得看哪里的海都是黑乎乎;2;0;2;9387;0.0002130606157451795
，如果你不画熊猫妆欢迎丫丫回家、大英博物馆门前变装跳舞、阻止日本排放核污水我是不会原谅你的;2;1403;1405;9387;0.1496750825609886
健康生活大自然大海坚决抵制日本排放核污水互联网会恢复记忆;1;5;6;9387;0.0006391818472355385
警惕“洗澡海鲜”，欧盟可能没安好心日本核污染水排海正式开始日本核污染水下午排入海洋日本排放核污水后你还会吃海鲜吗许泽玮的微博视频;1;1;2;9387;0.0002130606157451795
恶劣天气致日本至少人遇难他们排放核污水入海，现在遭遇台风，正好把污染的海水倒灌到他们陆地上。让他们自己享受核餐;2;11;13;9387;0.0013848940023436667
为什么全世界都无法阻止日本排放核污水？这个回答思路确实清奇。;69;880;949;9387;0.10109726217108768
直接用身躯堵住核污水排放的管道吧末日枪手可能现在反对日本排放核废水还来得及;1;0;1;9387;0.00010653030787258975
日本核废水排海超话呵呵，某些人真的是下头耶。别人说日本排放核污水，你们去说二维码是日本的，你们是万？大海都变成什么样了？一群下头人，你们说二维码是日本的，那有本事别让他们别用汉字呀。;1;24;25;9387;0.002663257696814744
日本核污水超话呵呵，某些人真的是下头耶。别人说日本排放核污水，你们去说二维码是日本的，你们是万？大海都变成什么样了？一群下头人，你们说二维码是日本的，那有本事别让他们别用汉字呀。;2;20;22;9387;0.0023436667731969747
日本核污水排放第天了;1;2;3;9387;0.00031959092361776926
日本排放核污水怎么没有声音了？日本民众就核污水排海提起集体诉讼日本核污染水已排海吨日本核污染水排海量已超吨;1;1;2;9387;0.0002130606157451795
日本民众提诉日本政府叫停福岛排海日本自民党提议滞销水产品供应学校月日，名日本民众，在福岛地方法院提起诉讼，叫停福岛排放污染水。这是日本国内第一起“核污染水排海”提诉的案子。这些民众为何反对福岛排海？中国禁运全部日本水产品，日本渔业受重创，记者探访东京筑地鱼市，当地游客展开;5;15;20;9387;0.002130606157451795
转发笑的我姐妹你听我解释我和你老公在日本旅游，看到日本开始往海里排核污水太生气了，你老公脱下裤子要把那个插到排放管里堵住排水口，这样的话地球就不会被污染了，但是当时水汽太大了，你老公一不小心就插到我这里了我也很疼我也是受害者但是你老公出发点是好的你别责怪他了姐，我展开;2;4;6;9387;0.0006391818472355385
欢迎大家明天来看我和两位科大同事以及抱朴仙人的直播直播预告日本核污水排海，该如何理解？如何应对？直播预告日本核污水排海，该如何理解？如何应对？袁岚峰风云之声发表于北京图片图片年月日，日本政府正式启动计划了两年多的福岛核污染水排海。这在国际上造成了巨大的争论展开;1;15;16;9387;0.001704484925961436
日本的经济来源于中国，有一些东西是没有办法避免的，但是尽力而为的东西是能让日本少赚的钱的，你不要以为平常用的东西消耗不了日本什么经济，日本都来源于中国，也是来源于人民所用的东西，你去调查就知道了，日本真正经济来源最多的在中国到底是什么东西，绝对不是手机零件不抵制你就等死吗？抵制等于制裁，抵制成功了，说不定少放几年核污水别以为一个人的力量微不足道，觉醒吧中国人日本核污染水已排海吨坚决抵制日本排放核污水;27;528;555;9387;0.05912432086928731
日本国驻华大使馆停止排放核污水，大海不属于你们。地球可以没有日本，但是不能没有海洋请停止继续压热搜。请立即停止排污水。;3;4;7;9387;0.0007457121551081282
福岛的核污水除了直接排到海里外，还可以选择固化填埋、电解排放、蒸汽排放、注入地表等处理方式。最贵亿美元。不要再说日本的工匠精神了，整个过程都提现了东电的唯利是图，消极应对美帝是不是又在研究清除人体内的放射性污染物了吧？资本都是些不要脸的玩意儿国际原子能机构对核事件的严重程度是分有等级的，其中最轻微的是级，最严重的是级。当福岛核电站最开始被地震和海啸袭击时，按标准仅是一个级核事故。结果在日本人的一系列骚操作下，该事故的严重性硬是从级一路攀升到了级，其实际后果甚至比历史上著名的切尔诺贝利核事故还要严重。日本人啊此处省去字无法过审的语言。这就是日本人在福岛核事故中的做派，那么我们现在再回过头来考虑这个问题：同样是这些人，他们现在会给全世界提供可靠的数据吗？月日，韩国媒体披露了日本拒绝其他国家对排污水域进行直接取样的事实。也就是说现在所有的检测样本均来自于东电公司。月日，在巨大的舆论压力下，东电公司终于承认目前储水罐中有约的核污水的放射性物质含量超标。更令人揪心的是，之前被日本人吹上天的那个过滤系统，现在被发现有很多已经损坏了。日本，崩了;2;2;4;9387;0.000426121231490359
小日本核污水自排海起目前已排放了吨网友：海洋不是日本人的下水道笔默君的微博视频;22;153;175;9387;0.018642803877703208
谁能想到后的主线任务就是活下去日本排放核污水情感共鸣家庭快乐的猩球的微博视频;1;2;3;9387;0.00031959092361776926
日本排放核污水的后果，俄罗斯已经证明过了;2;97;99;9387;0.010546500479386385
又特么被小日本排放核污水的新闻气到了，想问问分解核污水多少钱，我们可以给他水滴筹吗;1;2;3;9387;0.00031959092361776926
昨天吃海鲜，一堆人说我不注重自身健康，在日本排放核污水的当下，居然还冒险。接受大家监督，今天吃湘菜，红烧肉、炖鱼头、血浆鸭的走起;8;19;27;9387;0.0028763183125599234
无意引起争执纯属个人好奇蔡康永当年站在反台湾核电站第一排这次日本排放核污水他出来反对了吗？;45;862;907;9387;0.09662298924043891
逆水寒手游超话禁水产不是歧视，但是水产是不能玩游戏的，这是老祖宗留下的规矩。水产是不能玩的，水产玩了就全是污浊之气。我是为了你好才这么说的。这是传统文化，不是忽然来的规定。特别最近日本排放核污水，水产已经面目全非了;1;66;67;9387;0.007137530627463513
年月日，日本政府正式启动计划了两年多的福岛核污染水排海。这在国际上造成了巨大的争论，甚至中国国内舆论也产生了撕裂。一方面，中国外交部表示严正抗议，认为福岛核污染水排海计划的正当性、合法性、安全性一直受到国际社会质疑。另一方面，日本政府拉到了一把“尚方宝剑”：国际原子能机构（）出了个报告，认为日本排放的核污水是安全的。那么，我们对日本的行为究竟该不该反对？在争论的同时，老百姓的生活和心理已经立竿见影地受到了影响，有人担心中国渔业受到冲击，有人担心核辐射开始抢盐。我们应该如何理解这些问题？在个人和国家的层面，我们应该如何应对？中科大胡不归的微博直播《日本核污水排海，该如何理解？如何应对》;51;103;154;9387;0.01640566741237882
一直以为我不喜欢原来我只是不喜欢没营养的后日本排放核污水快乐的猩球的微博视频;1;1;2;9387;0.0002130606157451795
美食博主上线了（图简直就是噩梦，看到小日本排放核污水那天买了斤多的螃蟹，害两个人接下来一个礼拜都没食欲了，现在听到螃蟹两个字还想）每天都有在好好养我，我好好赚钱给你开个餐厅吧;1;1;2;9387;0.0002130606157451795
你的小鲸鱼与快乐小狗上线啦小鲸鱼细则请看即刻起可私信截止至关位娃友抽一位幸运伙伴送出半年内黑箱（仅限娃圈，黑箱本次可用）厦门娃展（）将展出小鲸鱼与快乐小狗，并且准备了少量现货（小鲸鱼套，快乐小狗套）与大家见面，欢迎来玩哦小模特周周的大牙特别鸣谢贰贰懒兔关于日本排放核污水入海事件，我希望借着本次娃展的机会，呼吁大家多多关注海洋生态问题。到场的小伙伴可以在卡纸上签名或画上小鱼表示支持，现场也准备了一些小零食与大家分享。期待与大家见面祝各位玩娃愉快娃衣超话超话日本核污水;27;25;52;9387;0.005539576009374667
兄弟們，我剛做了一件讓我感到安慰的小事。我來披薩餐廳吃今兒個的第一餐，坐我隔壁桌是兩個法國人，貌似一對情侶，其中女的正在喝午後紅茶，我想了一下，還是決定轉過身用我幾乎忘光的英文告訴她：不好意思，給份建議：以後如果妳想買點喝的，可以試試其他的選項，別再買這款飲料了。聞之兩人都停止了進食，同聲問我為什麼，我在大腦裡迅速搜尋組裝第一時間能喚醒的所有詞彙，然後重新看著他俩的眼睛，開始詢問他俩可有聽說日本將核污水排放進大海的消息，所幸他倆知道這事，我於是打鐵趁熱趕緊告訴他們：你們正在喝的那瓶飲料正是出自核汙染地區。說完我觀察了下他倆的表情，見反應正常便繼續說：日本政府為了要將這些不被信任的商品賣出去會在包裝上隱藏或改寫原產地資訊（此時法國小哥哥已經開始狂摳商品欄目上的覆蓋貼紙了）。你們在台灣島上，或許也會遇上許多對日本抱有好感的人，他們會告訴你不是每一樣日本商品都出自核縣，但是這些不被他國接受的日本産品一直都是由我們的政府接收的，而我們的政府和日本政府一樣並不在乎人民，只會說服要求我們去接受，因此在台灣島上有些人知道情況，也有些人不覺是個事，但你倆只是來旅遊的客人，因此我有義務提醒你們：如果你們想保障自己的健康，那麼在這座島上請不要選擇任何日本的産品，也盡量別碰海鮮。聽完我的這番話，法國小哥哥直接拎起那瓶午後紅茶丟進了垃圾桶，回頭更和法國小姐姐和我一同道了謝，告訴我他們從此會很小心的。沒多久他倆也吃完了，收拾好東西跟我揮了揮手便開了餐廳。望著他倆離去的背影，我突然覺得：能夠多懂一門語言實在是太好了，距上一次有這樣的感受還是在英國跟歐洲人講解南京大屠殺和一個中國的架構並使他們收起嬉笑認真對待的時候。所以再次回應那個恨國老問題：你這麼愛中國去啥外地講啥外語呢？我在海外和國內做的這些最小的事就是我最清楚的答案。;91;1333;1424;9387;0.1516991584105678
日本排放核污水大自然的警告来了，地震台风双重，接核污水倒灌日本日本台风来袭日本地震从小追剧挨了不少打的微博视频;1;3;4;9387;0.000426121231490359
老兵带你看世界直击一线情况俄民众：支持中国当局暂停进口日本水产品决定建议所有日本人移居俄罗斯网友：这真是个值得重视的好办法，关键是俄罗斯愿意收留他们，真得很棒俄罗斯还非常的大度哦日本排放核污水的影响有多大品茶说酒的微博视频;-1;28;27;9387;0.0028763183125599234
又有人为日本排放核污水洗地了？一看是逛鬼厕的劣迹艺人张瀚的粉丝，那不奇怪了;49;582;631;9387;0.06722062426760414
折断兵马俑手指的美国男子向中国道歉历史总是这么惊人的相似：年，中国大陆某些人计划把洛阳、西安、兰州、敦煌、新疆等地所博物馆及研究机构收藏的件丝绸之路的相关珍品国宝，送去日本展览，甚至还要在日本巡回展览到年；年，中国大陆某些人是力排众阻，不顾网友们的多次、长期举报，又把包括兵马俑在内的几百件国宝送去日本展览，某研究院甚至还洋洋得意、十分炫耀；年，中国台湾省某些人把《祭侄文稿》送去日本，至今怀疑有没有被日本调包；年前，日本人以借展为借口，骗走了《西冷八家印存》，至今不归还；年前，日本人故意砸毁了在日本展览的兵马俑，甚至一度不想归还兵马俑碎片，日本法院竟然判无罪；日本侵华时，日本毁掉、抢走了那么多中国文物、古籍，至今不归还。在日本从上到下都极端反华的情况下，在日本排放核污水的情况下，在日本至今都不归还所有中国文物的情况下，在日本曾经故意抢走、骗走、毁坏中国文物的情况下，某些人竟然三番五次、持续不断、大摇大摆、明目张胆、肆无忌惮的往日本送展中国国宝精日们已经到了如此丧心病狂的程度了，到底是谁在做这些精日的保护伞？？“中日友好”、“大棋论”、“冰箱论”已经成了精日、买办阶级、日本人的通行证、护身符。买办阶级、官僚阶级、精日、日本人很早就开始合流了。有些“大棋论”就是典型的精神分裂：一边强行拔高日韩，一边却又在说日韩注定会回归到历史上的小国。在这种“大棋论”的嘴里，未来与日韩的经济合作，仿佛能远超与俄这类真正的大国的合作，仿佛能远超与非洲、欧洲的合作，仿佛与日韩的合作会闪瞎历史、让祖坟冒青烟日本庙、日本医院、日本养老城、日本街、日本人社区、日本人学校日本在侵华时就有的老套路日本一直是“全民间谍”的策略，参考珍珠港事件里那些日料店就是间谍窝。买办阶级一直都在把“养寇自重”给包装成“大棋论”、“冰箱论”、“友邦惊诧论”。;1;11;12;9387;0.001278363694471077
李在明已绝食抗议天日本核污染水排海正式开始谁在炒作只有中国反对日本排放核污水月日，韩国最大在野党领袖李在明绝食抗议第天，坚持反对日本核污染水排海，指责尹锡悦政府施行“暴政”。这位还是挺有种的不愧是坚决抗日的那部分朝鲜民族的代表视频来自：四川观察的微博视频;3;20;23;9387;0.002450197081069564
央视新闻参考消息小日本核污水排放仅仅半个月就如此平静了，哪怕是偷偷从福岛地区进口了水产品，也就是轻描淡写地罚点不痛不痒的款这是要翻篇了吗？日本政府基本上对侵华基本从未正视过，这次又要放过他吗？日本只配永远被钉在历史的耻辱柱上时时刻刻要把它拿出来鞭笞，昭告天下;1;4;5;9387;0.0005326515393629487
海峡导报社的视频统派学者纪欣：只要我们抗议不断，日本核污水就排放不了年坚决抵制日本排放核污水;1;0;1;9387;0.00010653030787258975
小日子排放核污水后，不是地震就是中毒，导致万多条河豚等养殖鱼类死亡，真的是善有善报、恶有恶报日本核污水灰灰有娱的微博视频;2;17;19;9387;0.0020240758495792053
李在明已绝食抗议天绝食抗议，这都是木有的行动，苦了自己，便宜了敌人，这是没有斗争精神和斗争艺术的体现，要成功阻止日本法西斯排放核污水，只能是动员群众，组织群众，武装群众，发起全民抵制日货的行动，让日本法西斯的经济完全瘫痪，自然就会放弃排放核污水。;6;84;90;9387;0.009587727708533078
李在明已绝食抗议天日本排放核污水第十七天，我记得排放之前，日本就说要先排放天，第十七天，丝毫没有收手的意思;1;2;3;9387;0.00031959092361776926
老兵带你看世界听郭正亮讽日本强排核污水美专家称日本根本搞错重点最危险的可能不是氚，郭正亮做了一个直白的比喻网友：避重就轻的检测，能检测出啥名堂还不是你说了算吗日本排放核污水的影响有多大品茶说酒的微博视频;5;46;51;9387;0.005433045701502077
李在明已绝食抗议天韩国现政府默许日本向大海中排放核污水，激起在野党和韩国民众的强烈反对。;1;8;9;9387;0.0009587727708533077
日本排放核污水后国家较量正式开始卫星观地球的微博视频;16;108;124;9387;0.013209758176201129
日本人排放核污水时，我以为中国文化人都被掐死或变成哑巴了，此时这种激烈反映和愤怒，才知道它们还都有气儿;1;558;559;9387;0.05955044210077767
第批污水将排，日本有一群人不干了，直击岸田七寸，中国可效仿。日本核污水问题的后续来了。据日官媒介绍，第一批核污水排海将于月日结束。目前，东电公司正在为第二批核污水的入海做准备。相关数据显示，第一批核污水的总量为吨，第二批总量应该也差不多是这个数。仅是年，日本就规划了次这样的污水排放，加起来的总量为万多吨。而更令人担忧的是，如此巨大的污水量也仅仅是目前储水罐中总量的。不知现在大家是否理解，为何中国从一开始就反对排放，因为这件事有一就有二，对世界海洋的伤害将是难以估计的。中国会反对，完全是本着对全人类负责的态度。值得一提的是，估计连岸田文雄自己也想不到的是，除了中国及周边国家，就在这两天，日本国内有一群人也不干了。月日，一群日本律师开始行动了，他们代表名福岛居民和渔民，向福岛地方法庭提起诉讼，他们的诉求很简单：必须停止核污水排海。只能说，在日本国内还是有一群有识之士。作为原告方律师，他们状告的对象既包括日本政府，也包括核电站的运营商东电公司。这些律师指出了二者的“两宗罪”：年，他们未能阻止福岛核电站发生事故，这第一次损害了当地渔民和居民的利益；年，他们将核污水排入海洋，这是第二次损害了当地渔民和居民的利益。笔者个人觉得，这群律师“这一仗”打得是真漂亮。因为，他们对日本政府及东电丑恶嘴脸的揭露，不止局限在眼前的核污水排海，还聚焦到了年的事。这一点，很多中国网友可能都忽略了：日本政府和东电的不负责，从那时候就能看出来。同时，此次这些日本律师还曝光了一份文件，作为证据。原来，早在年，日本政府和东电公司就同渔民协会白纸黑字，签了一份承诺性文件。按文件规定，在没有获得当地所有利益相关人员同意前，政府不可以擅自排放核污水。然而，月份，日本却不顾渔民协会的反对执意排污。应该说，这些律师的策略，击中了岸田政府的七寸。因为，他们把事情的前因后果都向世人展示清楚了，又拿出了有利于自己的证据，将岸田政府官员及东电撒谎、不顾他人利益的一面，揭露了出来。不管他们最后的诉讼结果如何，都值得我们点个赞。同时，这也意味着，岸田文雄砸钱安抚当地渔民和居民的做法，没有起到多大作用。早前，岸田政府曾砸了亿，成立了一个基金，为的就是“稳定”当地水产业。几天前，岸边政府又砸进去亿，并称要对依赖中国出口的渔民进行补助。现在看来，他们做的这一切，很多渔民根本不接受。事实上，这些渔民的做法也是值得我们中国效仿的。可能大家也注意到了，日前中国出台了一项法规：《外国国家豁免法》。该法一条条地都说清楚了，外国政府的哪些行为，是不能在中国获得豁免的。运用在日本核污水排海上，也就是说日本政府和东电公司的行为，对中国造成的损害，中国就依法追责。该法的推出，正是为了明确清楚涉外的这些具体问题。几天前，日本已经向递交了文件，要告中国的状，要求中国恢复对日本水产品的进口。这已经是日本方面，对中国出招了。接下来，马上日本将二次排污，相信周边国家还会有越来越多的人站出来，同中国一起对他们说“不”。;69;777;846;9387;0.09012464046021093
第批污水将排，日本有一群人不干了，直击岸田七寸，中国可效仿。日本核污水问题的后续来了。据日官媒介绍，第一批核污水排海将于月日结束。目前，东电公司正在为第二批核污水的入海做准备。相关数据显示，第一批核污水的总量为吨，第二批总量应该也差不多是这个数。仅是年，日本就规展开;81;777;858;9387;0.09140300415468201
日本科技体现在哪，清洁机器人都没有，以前可能吹了，话说回来，要夸日本人认真，核污水排放之前那么多时间，都在一直推卸责任，不作为，一直拖成无法避免的灾难食色性也哟喂国籍一换估计就是磨洋工了一块污渍还个人弄了几分钟。;19;24;43;9387;0.004580803238521359
凤凰网，对日本核污水排放入海，还真是关怀体贴日本的措施还是有效果旅日游客称不介意福岛鱼：没关系啊很干净近日，凤凰全球观察团在日本东京最大的鱼市场之一筑地市场进行了采访，关于是否还会购买福岛鱼产品，来自世界各地的游客给出了不尽相同的答案。“完全不介意”，一位来自日本大阪的游客称，“因为日本政府每天都在发表放射性氚的检测结果”。而另一位大阪游客则表示虽然有些介意，但为了表示对海啸大地震灾区的支援，还是会选择购买。来自中国台湾的一位游客认为核污水事件对台湾影响不大，福岛鱼“很干净、很卫生”。而来自新加坡和澳大利亚的两位游客都表示对此并不太关心，会照常食用。网页链接;-3;17;14;9387;0.0014914243102162564
旅日游客称不介意福岛鱼和海鲜，时至今天日本核污水排放已超万吨，污染面积也在迅速扩大，在世界大部分民众反对的情况下，媒体随机采访了旅日的游客，居然还有很多游客称其不介意并且觉得很新鲜，这是东电的公关费起到作用了么看看日本人自己吃福岛海鲜的反应吧，嘴上说没事，身体很诚实栗香派派的微博视频;127;754;881;9387;0.09385320123575157
日本民众提起诉讼要求停止核污染水排海日本民众就核污水排海提起集体诉讼据日本时事通信社报道，约名日本民众日向福岛地方法院提起诉讼，要求日本政府和东京电力公司停止核污染水排海。据报道，福岛、宫城、岩手、茨城、千叶、东京、新潟等地居民及渔业从业者约人，当日起诉日本政府和展开;18;144;162;9387;0.01725790987535954
热搜第一检测出放射性物质韩国石斑鱼大量死亡日本排放福岛核废水不仅影响了本地渔民的生计，更是破坏了大自然的平衡，甚至威胁人类生存。最近，因日本核废水影响，韩国不少养殖场的石斑鱼大量滞销，只被迫挤在箱网中，最终因水温过高出现大量死亡，引发广泛关注，话题韩国石斑鱼大量死亡一度展开;1;4;5;9387;0.0005326515393629487
哇咔咔，日本会停止排放核污水的吧？快手快手小弱弱敬众生的快手视频;1;0;1;9387;0.00010653030787258975
预制菜话题将掩盖日本排放核污水的关注热度，这是日本人启动被渗透中国人（走狗）的又一计划，日本将循序渐进地蚕食中国的各个领域，制造社会焦虑，激化社会矛盾，从而达到它们进军中国的目的由一开始的教育机构，如今热度完全消退，曹贼之流书刊依旧如故；其次是汉奸舆论导向，譬如某电台的驻日记展开;0;2;2;9387;0.0002130606157451795
预制菜话题将掩盖日本排放核污水的关注热度，这是日本人启动被渗透中国人（走狗）的又一计划，日本将循序渐进地蚕食中国的各个领域，制造社会焦虑，激化社会矛盾，从而达到它们进军中国的目的由一开始的教育机构，如今热度完全消退，曹贼之流书刊依旧如故；其次是汉奸舆论导向，譬如某电台的驻日记者，国内所谓的某教授等等；再而是政府机关部门等等。我爱咱们的国家啊可是汉奸走狗遍地开花，让人窒息;1;2;3;9387;0.00031959092361776926
日本民众就核污水排海提起集体诉讼日本第二批核污染水共吨日本时事通信社报道，约名日本民众日向福岛地方法院提起诉讼，要求日本政府和东京电力公司停止核污染水排海。报道称，这是日本首起有关叫停核污染水排海的集体诉讼。东电公司日表示，第一轮排放的核污染水总计约吨，预计首批核污染水将于日下午全部排放。第二轮排放的核污染水预计总量同样为吨，东电公司将于本月下旬公布具体排放计划。日本民众提起诉讼要求停止核污染水排海;4;6;10;9387;0.0010653030787258974
日本民众提起诉讼要求停止核污染水排海日本民众就核污水排海提起集体诉讼据日本时事通信社报道，约名日本民众日向福岛地方法院提起诉讼，要求日本政府和东京电力公司停止核污染水排海。据报道，福岛、宫城、岩手、茨城、千叶、东京、新潟等地居民及渔业从业者约人，当日起诉日本政府和东电公司，要求停止核污染水排海。报道称，这是日本首起有关叫停核污染水排海的集体诉讼。据日本共同社报道，提起诉讼的日本民众在起诉书中称，核污染水排海侵犯了民众平稳生活的权利，渔业从业者维系生计面临困难。要求日本原子能规制委员会取消排海许可，禁止东电公司继续将核污染水排放入海。据福岛中央电视台报道，起诉书称，“实施故意污染环境的行为是违法行为，不能容许”。据日本时事通信社报道，东电公司日表示，第一轮排放的核污染水总计约吨，截至日已排放约吨，预计首批核污染水将于日下午全部排放。报道称，第二轮排放的核污染水预计总量同样为吨，东电公司将于本月下旬公布具体排放计划。中国新闻网;10;150;160;9387;0.01704484925961436
日本民众起诉日本政府及东电，要求停止核污水排海据澎湃新闻报道，当地时间月日，日本多地民众起诉日本政府及东京电力公司，要求其停止核污水排海计划。来自日本福岛县、宫城县等地的约名民众日向福岛地方法院起诉日本中央政府和东京电力公司，要求其叫停月启动的福岛第一核电站核污水排海计划。原告方律师团称，这是日本全国首起有关叫停核污水排海的诉讼。起诉书称，原告认为核污水排海侵犯了日本民众平稳生活的权利，渔业从业者维系生计面临困难，因此要求日本原子能规制委员会取消排海许可，禁止东电继续将核污水排放入海。月日，日本福岛第一核电站核污水排海正式启动。根据东电计划，年将分次排放万吨核污水，每次约排放吨，首次排放需要天左右。央视新闻消息援引日本时事通信社消息称，东电月日表示第一轮排放的核污染水总计吨，截至日已排放吨，预计首批核污染水将于本月日下午全部排出，随后将使用工业用水冲洗排海相关设备，以清理残留在设备中的核污染水。核污染水第二批排放预计最快将于本月底开始。;9;125;134;9387;0.014275061254927026
霜晨一晓月日本排放核污水，中国的知识阶层一片沉默。而《治安管理处罚法》中增加处罚损害中华民族精神，伤害中华民族感情的相关内容一出台，它们立马又群情激奋起来。原以为他们被掐死了的。;5;304;309;9387;0.03291786513263023
大海啊，什么时候又才能见到你那美丽的样子反对日本排放未处理核污水超话大海啊超话日本核废水又是恨日本的一天;1;7;8;9387;0.000852242462980718
开海后威海石岛第一批打鱼船满载而归，鱼类不少，有太平洋真鳕鱼，比春节便宜了很多，今天下了四单，自家一箱，宣城亲家两箱，曹淑英一箱，另外给曹淑英又拍了一箱带鱼，共花了个元再加一元。能囤就存点。小日本排放核污水，不知道将来海洋鱼类还能不能吃。环境毁灭生灵涂炭，美国和日本鬼子都是人类灾星;1;0;1;9387;0.00010653030787258975
一定要注意日用品，避免受核辐射影响的产品核辐射的危害日本排放核污水避雷甜乃奈的微博视频;1;5;6;9387;0.0006391818472355385
韩政府增印福岛核污水谣言宣传手册，被疑“帮日本宣传”韩政府花亿印核污水辟谣宣传手册环球网消息，韩国《京乡日报》日报道称，韩国文化体育观光部花费约万韩元（元人民币约合韩元）印刷了一本名为“关于福岛核污染水的个谣言”的宣传手册，并从本月日起将其上供乘客观看。报道称，韩国政府此举引发本国部分民众的不满，并在韩国网络上引来了批评。有网友称“真的不理解韩国政府为什么给日本做宣传做到这个地步”。报道称，此前韩国政府已制作万本宣传册放置在了中央行政机关和居民中心等公共机构。为了放置在列车上，政府又追加万韩元的预算制作了本宣传手册。据估计，这两次印刷宣传手册总费用共达到了亿韩元。报道介绍称，宣传手册上列举了关于福岛核污染水的个“谣言”，包括“核污染水全部都是放射性物质”“国际原子能机构（）对日本持偏袒态度”“韩国政府只相信国际原子能机构（），不对真相进行验证”等等。宣传册中写道“这些谣言完全没有根据”“是假新闻”。报道称，对于政府将宣传手册放置在高速列车座位上的做法，一些市民认为这是浪费国家预算的行为，并认为政府将国民对排放污染水的担忧定性为谣言或假新闻并不合适。另外，一位乘坐开往釜山列车的乘客称，“排放污染水是日本的政策，不是大韩民国的政策，真不知道为什么要把税金用在这种地方”。此外，全国铁道工会也批评政府发放污水排放宣传手册的做法，号当天发布声明称，将铁路作为单方面政权宣传的手段，建议回收列车上的宣传手册，将其放置在日本的新干线上。此消息在韩媒报道后，引发了韩国网友吐槽。有人质疑说“这个政府又不是日本政府，拿着韩国国民的税金在干什么呢？我们为什么要为日本做这种事？”还有人调侃称，“做到这个程度的话，执政党不要称国民力量党了吧，应该叫日本力量党。”;20;30;50;9387;0.005326515393629488
我们都知道日本一直企图混淆视听，把正在排放的核污水洗成核废水，核污水是直接跟核芯接触的具有核辐射的水呀，微博搜索日本关键词出来的模糊搜索全是核废水日本核污水的模糊搜索被删掉了这背后是什么力量;-1;6;5;9387;0.0005326515393629487
企业回应把日本食材引进无锡学生餐你看，日本排放核污水，日本参股推进预制菜，然后日本海域污染的鱼类再做出预制菜端上中国人的饭桌，多完美的一条产业链，又谋了财，又害了命;1;331;332;9387;0.0353680622136998
日本核污染水已排海吨据日本时事通信社报道，日本东京电力公司当地时间月日称，“福岛第一核电站核污染水第一批排放入海的总计吨，截至日已排放吨，预计第一批核污染水将于日下午全部排出，随后将使用工业用水冲洗排海相关设备，以清理残留在设备中的核污染水。核污染水第二批排放预计最快将于本月底开始”。中新视频的微博视频;33;131;164;9387;0.017470970491104718
日本开始排放核污水开始全人类及全世界的动植物也将受到前所未有的核伤害与其他污染相比核污染具有危害范围大、破坏性强、持续时间长且事后处理复杂的特点核污染产生的放射性核素可对机体产生较强的辐射对人体可导致急性放射病、白细胞下降还可能影响生育甚至导致癌症;7;101;108;9387;0.011505273250239693
海洋是人类的重要食物来源之一，日本排放核污水让海洋生物匮乏并且被污染不能食用，这是导致粮食危机的重要原因之一。联合国竟然搞出一个外来物种入侵海洋外星物种吗明明是日本核污水排海导致海洋生物大量死亡，联合国竟然看不见要排年啊美国竟然支持日本核污水排海，地狱空荡荡恶魔在鹰酱;1;79;80;9387;0.00852242462980718
持续关注日本核污水排海日本核污染水已排海吨据日本时事通信社报道，日本东京电力公司当地时间月日称，“福岛第一核电站核污染水第一批排放入海的总计吨，截至日已排放吨，预计第一批核污染水将于日下午全部排出，随后将使用工业用水冲洗排海相关设备，以清理残留在设备中的核污染水。核污染水第二批排放预计最快将于本月底开始”。疯狂大象中新视频中新视频的微博视频;1;0;1;9387;0.00010653030787258975
已排吨日本预计月底开始第轮核污水排放据日本时事通信社日报道，日本东京电力公司当天称，福岛第一核电站核污染水第一轮排海的部分，预计将于日下午排完既定量核污染水，日将使用工业用水冲洗核污染水排海相关设备，以清理残留在设备中的核污染水。第二轮排放最快预计将于月底开始。根据东电公司公布的信息，第一轮排放的核污染水总计吨，截至日已排放吨。看看新闻的微博视频;-15;7;-8;9387;-0.000852242462980718
日本核污染水已排海吨日本已排放核污水吨，预计第一批核污染水将于本月日下午全部排出，最快将于月底开始第二批核污染水排海。（来源：国际时讯）李小安的微博视频;1;1;2;9387;0.0002130606157451795
香港黑色暴雨警告香港联合证券交易所因黑色暴雨暂停交易，学校停课，非必要不外出，今天一直在认真躲雨。不懂就问：日本排放核污水之后的雨是不是不能淋（已经淋过了）健身超话我的周五关键词香港暴雨;59;145;204;9387;0.021732182806008308
抵制日货，日本停止排放核污水，日本道歉;-4;1;-3;9387;-0.00031959092361776926
最近看到消息说日本已经排放了超吨的核污水但是日本排放核污水的热度又被压下去了以至于我在小红书上很少会看到有关日本核污水排放超吨的消息;1;1;2;9387;0.0002130606157451795
一张图证明广东的雨有多大是不是因为日本排放核污水才会有水灾啊哪哪都淹，怎么日本不淹;1;4;5;9387;0.0005326515393629487
日本第二批核污水排海或月底开始据日本时事通信社报道，月日，东京电力公司表示，福岛第一核电站核污染水第一批排海将于月日结束，最早将于月底开始第二次排放准备工作。据东电公司称，福岛第一核电站核污染水第一批排放入海的总计吨，截至日已释放约吨。预计第一批核污染水将于日下午全部排出，日将用工业用水冲洗管道中残留的核污染水。东电将在此次排海结束后对排放核污染水的设备进行检查，检查结束后将开始为第二次排海做准备，计划再排海约吨。当地时间月日时许，日本无视国际社会多方反对，将福岛核污染水排入大海。按计划年将共计排海次，预计总排放量为万吨，相当于目前储水罐总蓄积量的。;1;4;5;9387;0.0005326515393629487
这么喜欢问东问西，管着管哪，你怎么不去管管日本排放核污水啊;1;0;1;9387;0.00010653030787258975
特朗普公开谴责日本核污水排海，并嘲讽拜登为“绿巨人”特朗普公开嘲讽日本的核污水中包含有没有经过处理的上百种放射性元素，而对于“瞌睡乔”支持日本排放核污水的行为，特朗普也是语言辛辣地表示“希望这穿着纸尿布的家伙喝一杯排泄物，自己衷心祝愿拜登成为绿巨人。”;56;951;1007;9387;0.10727602002769789
日本核污染水已排海吨据日本时事通信社报道，日本东京电力公司当地时间月日称，“福岛第一核电站核污染水第一批排放入海的总计吨，截至日已排放吨，预计第一批核污染水将于日下午全部排出，随后将使用工业用水冲洗排海相关设备，以清理残留在设备中的核污染水。核污染水第二批展开;17;42;59;9387;0.006285288164482795
看到这个就越发的心酸和愤怒，日本所谓的政客凭什么把海洋当成他家的下水道，随意排放核污水，污染这些美好生灵的家。;2;69;71;9387;0.007563651858953873
日本核污染水已排海吨据日本时事通信社报道，日本东京电力公司当地时间月日称，“福岛第一核电站核污染水第一批排放入海的总计吨，截至日已排放吨，预计第一批核污染水将于日下午全部排出，随后将使用工业用水冲洗排海相关设备，以清理残留在设备中的核污染水。核污染水第二批排放预计最快将于本月底开始”。中新视频中新视频的微博视频;17;42;59;9387;0.006285288164482795
日本第批核污水排海或月底开始据日本时事通信社报道，日本东京电力公司当地时间月日称，“福岛第一核电站核污染水第一批排放入海的总计吨，截至日已排放吨，预计第一批核污染水将于日下午全部排出，随后将使用工业用水冲洗排海相关设备，以清理残留在设备中的核污染水。核污染水第二批排放预计最快将于本月底开始”。日本核污染水已排海吨中新视频中新视频的微博视频;17;15;32;9387;0.003408969851922872
日本核污染水已排海吨突然想到一个阴谋论，如果日本排放的不是核污水，只是烟雾弹。等到各国抽样检测证明水质没问题后，才真正排放核污水。嘶希望我想多了。赌它小日本是真的蠢。;1;2;3;9387;0.00031959092361776926
日本核污染水已排海吨禁止日本渔业产品入境销售是完全正确的措施。世界各国都应该加强对日本越界非法捕鱼，特别是非法捕鲸的行为进行严厉打击。让日本吞下排放核污水的后果。网络上那些天天吹嘘日本环保做得有多好多好的中国环保专家，好像都集体失声了天天晨读;21;111;132;9387;0.014062000639181848
虽然北京新闻广播拼命带节奏，但民意不可违这个法律确实温柔了一点，我建议，将亲日入刑，从重处罚日本是中华民族世仇，所有亲日媚日舔日行为均为汉奸日本已排放核污水吨;14;185;199;9387;0.02119953126664536
明星大咖超话日本核污水排放或因台风而倒灌，善恶终有报，老天爷都看不下了台风明星搞笑吐槽综艺迷惑行为大赏万万没想到娱乐优质博文上热搜开放计划亿点曝光计划小叮叮娱乐的微博视频;1;2;3;9387;0.00031959092361776926
《日本的核污水排放计划终于遇到阻力。日本政府宣布，将暂停核污水的排放，以保护海洋生态环》浏览量：万点赞量：网页链接;1;0;1;9387;0.00010653030787258975
日本核污水东电大股东的是世界经济论坛董事会成员，这是美国总统候选人小罗伯特肯尼迪说的。预告了大流行，月赞助了事件，之后武汉大流行爆发。官网表示要让人们一无所有，现在核污水用上了，美国支持，所谓的国际机制都是支援乌克兰的麾下国家。越来越明显，日本核污水排放就是折腾世人的核攻击。;1;8;9;9387;0.0009587727708533077
日本核污水排放的第十六天此时此刻我们已经到达雷公尖了我好幸福好开心好兴奋湾里都在我的脚下这里的风真的好舒服星星真的好多整个爬山的过程都很欢乐很累但是真的有快感把一辈子说的话都说完了在顶上许下我们十一个人前途似锦平平安安人生就是需要这些疯狂的时刻接下来就等一个日出吧;1;1;2;9387;0.0002130606157451795
清华大学团队以天后日本核污水才会影响中国沿海的错误报告，误导国家，让国家猝不及防，居心何在？月日月日，不到半个月时间。日美排放核污水之前，早就对洋流等因素对核污水排海后的状况十分了解了难道它们不知道核污水最先危害哪里吗？日美最想以核污水核攻击的就是中国;2;903;905;9387;0.09640992862469372
日本月底开始第二批核污染水排海日本已排放核污水吨据国际时讯报道：据日本时事通信社报道，日本东京电力公司今天（日）称，“福岛第一核电站核污染水第一批排放入海的总计吨，截至本月日已排放吨，预计第一批核污染水将于本月日下午全部排出，随后将使用工业用水冲洗排海相关设备，以清理残留在设备中的核污染水。核污染水第二批排放预计最快将于本月底开始”。;20;95;115;9387;0.012250985405347822
本來我是想初三隨便中考完去日本隨便找個便利店當收銀小妹的結果現在核污水排放我貓不讓我去了還說要抗日去;1;0;1;9387;0.00010653030787258975
日本排放核污水在高考地理中的考点高中地理;1;2;3;9387;0.00031959092361776926
日上崩了日本排放核污水第十五天;19;74;93;9387;0.009907318632150847
金坷垃喜羊羊的视频核污水排海十几天了，最让人担心的事情还是发生了？大家快看看吧坚决抵制日本排放核污水日本花亿搞公关还想夺去我们中国的中医？？什么东西？？没典脸;1;0;1;9387;0.00010653030787258975
日本核污水已经排放很多天了。。。还是希望能出现转机，希望我们的国家能够联合一切可以联合的力量，制止日本政府继续排放核污水;1;0;1;9387;0.00010653030787258975
天呐万亿日本排放核污水或导致日本的直接经济损失是万亿岸田文雄这下有点慌了，派经济团体来大国访问，希望能够给他们挽回一点经济损失不知道小本子怎么这么可恶，排放核污水是我们严辞拒绝的，但是他们根本就不理我们，依然排放核污水现在有损失了，又突然来找我们，求我们，希望我们给他们挽回一点经济损失，真的把我们当成他们的提款机了我们钱多花不完了会给小本子帮忙小本子也是够忒不要脸的，自己做了伤天害理的事情，还有脸找我们求帮忙。不得不说，这么无耻卑劣的行为，也只有小本子能做得出来了。;83;686;769;9387;0.08192180675402153
真相来了日本专家承认，目前日本核污水排放检测数据没有任何参考价值。日本核专家河田昌东在接受媒体采访时表示，由于日本现在排放的核污水较少，虽然公布的氚浓度达标，但显然在这样的情况下的检测数据没有任何参考价值，河田昌东还强调，日本方面现在公布数据的真正目的就是要在核污水排海最初阶段操纵舆论、妨碍人们了解真相。据悉，河田昌东曾担任日本“切尔诺贝利支援中部”理事，显然，这位日本专家道出了真相。;2;117;119;9387;0.01267710663683818
老兵带你看世界直击一线情况日方敦促中方采取措施平息民众情绪中方要求日方停止强推排海计划网友：一点反悔之意都没有，还要求我们，你停止了吗？有什么资格要求日本排放核污水的影响有多大品茶说酒的微博视频;4;20;24;9387;0.002556727388942154
谁能想到后的主线任务就是活下去日本排放核污水情感共鸣家庭幻想当一只熊猫的微博视频;1;2;3;9387;0.00031959092361776926
日本排放核污水最大的受害者是谁啊？明明是我啊，连吃四天虾了，最好都是冷冻虾;1;0;1;9387;0.00010653030787258975
日本核污水日本疯了吧持续排放持续排放能不能要点脸啊全世界都在谴责啊安全的话您自己喝了吧日本已排放超吨核污染水;1;2;3;9387;0.00031959092361776926
日本排放核污水后你还会吃海鲜吗对于日本排放核污水后，我们应该陷入辐射恐慌吗？鸿儒计划评智库评论员何亮亮的微博视频;7;30;37;9387;0.003941621391285821
日本排放核污水第十五天。海洋不是日本的污水池日本为排核污水斥巨资公关谁在给日本排核污染水洗白;1;0;1;9387;0.00010653030787258975
自年月日点日本开始排放核污水开始全人类及全世界的动植物也将受到前所未有的核伤害那怎样防治核辐射带来对人体的伤害应该是重中之重的大问题;1;101;102;9387;0.010866091403004154
“为向日本抗议，已绝食第天”韩国在野党党首李在明敦促尹锡悦政府，向国际法院起诉日本排放核污水。目前已经绝食天的李在明，面容憔悴，无精打采蓝色的烟卷的微博视频;16;92;108;9387;0.011505273250239693
日媒称日本对华水产品出口可能减至零日本排核污入海第十五天，日本排放核污水日记出口水产品趋近于零。;1;2;3;9387;0.00031959092361776926
对啊，日本排放核污水，林志玲怎么不吭声了？;37;442;479;9387;0.051028017470970494
尹锡悦政府：韩国最大在野党没资格抗议日本核污水排放。遭呛声喝了核污水吗视频来源：海峡新干线月日深柳斋的微博视频;2;8;10;9387;0.0010653030787258974
科学家称年前美国或杀死了外星生命科学家称年前美国或杀死了外星生命。年前他们还上过月球呢美国说的话你也信一个把沙土堆起来当做月球表面的流氓。一个支持日本排放核污水却不吃日本海鲜的流氓。美国在地球上剩下的使命就是等着有人去消灭它，还地球以和平和美丽。云中漫步艺术画廊超话;2;6;8;9387;0.000852242462980718
股日本核污水排放都没这样惨，没有脊梁的民族;1;0;1;9387;0.00010653030787258975
日本为操控舆论初期只排少量核污水日专家谈监测核辐射浓度低日本政府强行排放福岛核污染水，日专家认为，排海后东电虽公布氚浓度达标，但东电在最初阶段只排放较少核污水，当前的检测数据没有参考价值。（凤凰卫视胡越东京报道）凤凰卫视的微博视频;9;74;83;9387;0.00884201555342495
近期在网上看到很多网友发帖称，有很多日本企业在国内大批量收购野生中药材，基本上都是治疗肿瘤，癌症，和对防核辐射有效果的药材，甚至对一些不需要使用根入药的药材都要求连根拔起，对酸枣这种药材都要求在摘完果实后把枣树砍断。中医中药起源于中国，野生中草药是大自然留给中国人的瑰宝。近期日本不顾全人类的安全，肆意排放核污水，危害人类健康，加上这些年日本企业收购国内的药企，中成药制药厂，自来水厂，危害中国之心昭然若揭，希望国家有关部门能够重视起来勿让再次“侵略”中国;1;4;5;9387;0.0005326515393629487
阴险日本排放核污水之前，曾花高价在中国内地收购盐业公司国家现在应该出手，予以强制让日本人退出盐业公司不能让日本人控制国内的食品行业公司网页链接;2;9;11;9387;0.0011718333865984873
日本为操控舆论初期只排放少量核污水专家称当前核污水检测数据没有价值日本政府强行排放福岛核污染水，日专家认为，排海后东电虽公布氚浓度达标，但东电在最初阶段只排放较少核污水，当前的检测数据没有参考价值。“目前的监测核辐射浓度当然会很低，他们这么做的目的，就是要在最初阶段操纵舆论。这么做会妨碍人们了解排海真正的影响。”日本“切尔诺贝利支援中部”理事河田昌东说。（凤凰卫视）凤凰卫视的微博视频;8;74;82;9387;0.008735485245552359
日本排放核污水这事是没有热度了吗;1;0;1;9387;0.00010653030787258975
日本把核污水排海在公海里，离中国公海最近伤害中国最深，中国民众和韩国日本俄罗斯人民对此强烈不满，中国政府应出动维和部队打掉日本自卫队和政府，维护世界海洋生态环境资源平衡，打掉日本政坛收复日本，让中国治理他们的政权世界原子能机构说了，排放核污水跟他们没关系，是日本政府自己决定的，日本不该打吗？咱中国的枪炮是干啥的看画的吗？;1;1;2;9387;0.0002130606157451795
罗爷睿评光计划海洋不是日本的污水池日本东京电力公司发布消息称，福岛核废水排放口取样的海水中，检测出的放射性物质氚浓度达每升贝克勒尔。俄罗斯专家表示这个数据严重超标，该浓度的氚也能使人类患癌风险增加倍反正日本这家东电公司的说法和数据肯定是不能全部相信的，因为这家公司已经多次公然在核电站安全运行数据方面造假，这也是为什么当初福岛核电站事故爆发严重的根本原因。日本已经排放了吨的核污水，看来只有使用极端方式才能阻止日本的危害行为;9;17;26;9387;0.0027697880046873334
日专家谈监测核辐射浓度低：日本为操控舆论初期只排少量核污水日本政府强行排放福岛核污染水，日专家认为，排海后东电虽公布氚浓度达标，但东电在最初阶段只排放较少核污水，当前的检测数据没有参考价值。“目前的监测核辐射浓度当然会很低，他们这么做的目的，就是要在最初阶段操纵舆论。这展开;11;105;116;9387;0.012357515713220411
日本排放核污水，中国人在年前竟然预言到了人性商站学院电子商务阿栋彩云南现的地方的微博视频;4;12;16;9387;0.001704484925961436
日本核污水还在排放，抗争不能停下来从现在开始，我自己能做的就是不够买任何日本产，日本品牌的商品，以及不去日本旅游，虽然深知日本人民也是此次事件的直接受害者，但是在这个特殊时期，尤其是邻国需要团结起来，一起向日本施压，迫使他们停止将核污水继续排海的行为暂时用不了最爱的卸妆油和隔离霜了，还好家里还有几瓶囤货;8;21;29;9387;0.0030893789283051028
老兵带你看世界直击一线情况日媒：日本就中国禁水产品进口向世贸提交文件，声称中方措施“完全不可接受”无耻之极，还倒打一耙网友：这无耻的事做的淋漓尽致还有谁能做到日本排放核污水的影响有多大品茶说酒的微博视频;29;109;138;9387;0.014701182486417386
“日本排放核污水后竟然出现了新鱼种？”《破产玩具公司》排放核污水超话日本核污染水排海正式开始坚决抵制日本排放核污水研究称日本核污水排海天到达中国模型空间站的微博视频;1;0;1;9387;0.00010653030787258975
日本核污水日本已排放超吨核污染水;1;0;1;9387;0.00010653030787258975
校果一周轻洞察一周轻洞察第期来了快看过来，这周内容很精彩茅台瑞幸联名刷爆全网，多家瑞幸门店显示售罄，抢不到的小伙伴也不要心急，瑞幸回应酱香拿铁将成常驻产品。日本执意排放核污水，消费者开始全网征集好用国货排行榜，泼天富贵要落在国货身上了校果一周轻洞察校果研究院校园推广校园营销茅台瑞幸酱香拿铁一杯酱香拿铁含约毫升茅台酒瑞幸回应男子怒砸多杯酱香拿铁日本已排放超吨核污染水胡歌早晚美拉德;1;0;1;9387;0.00010653030787258975
老兵带你看世界直击一线情况日本电视台日报道，东电方面承认，目前储罐中约有的核污染水放射性物质含量超标。在被问及核污染水何时能够全部排完时，东电危机公关负责人竟然称，究竟何时能够全部排完核污染水，东电目前并没有任何具体计划日本排放核污水的影响有多大品茶说酒的微博视频;7;28;35;9387;0.0037285607755406414
日本花式洗白核污水：未提及的核污水被日本标记为假消息在日本月日启动福岛核污染水排海后，我们在海外社交媒体上发现，没有提及（多核素处理系统）的“日本核污水”相关帖子均被弹窗提示为“假消息”。同时，部分日本媒体大肆炒作中国核电站正常排放的核废水，还指责中国民众打“骚扰电话”，却只字不提右翼反华势力在中国驻日使馆前闹事。还有一些西方媒体则把大量关注放在中国的反应上，给中国对日本的水产品采取的紧急措施贴上“攻击”“报复”等标签。起底工作室的微博视频;3;19;22;9387;0.0023436667731969747
日本核污水海洋日本排放核污水第二天第十五天，还有两天，日本第一轮排放结束。我们可以阻止下一次排放吗？日本已排放超吨核污染水;1;1;2;9387;0.0002130606157451795
日本核废水排海超话咱就是说，现在热度越来越低，世界可以没有日本，但不能没有海洋坚决反对日本排放核污水;3;5;8;9387;0.000852242462980718
以前很喜欢云南入秋后的雨天，特别湿，可以清心润燥。今天是日本排放核污水之后第一次下雨，心境完全不同了，不敢想象几十年后被雨水腐蚀过的皮肤、不断渗透到身体里的钚啊、氚啊等等放射性元素大多数的我们现在就只是一个除了愤怒之外什么都做不了的年轻人，但是起码声音不能停止，起码不要只做看客日本核污染水已进入大海日本政府正式决定福岛核废水排海历史会记住日本政府这一笔;1;5;6;9387;0.0006391818472355385
老兵带你看世界听董智森讲日本强排核污水，台当局的态度民进“当局”会买日本水产吗？董智森：想想“莱猪”假羊肉吧网友：最后还是由台民众当冤大头日本排放核污水的影响有多大品茶说酒的微博视频;4;19;23;9387;0.002450197081069564
日媒评中国拒绝加入处理水评估国际机制日媒曝“中国拒绝加入日方建议的核污染水评估国际机制”：再次凸显中方强硬姿态“中国拒绝加入日方建议的处理水评估国际机制。”日媒称，这再次凸显出中方反对核污染水排海的强硬姿态。月日，日本共同社独家报道称，关于东京电力福岛第一核电站核污染水排海，日本政府曾向中方建议加入国际原子能机构（）的所谓国际机制，但中方拒绝。日媒介绍称，该机制由多个国家研究机构组成，将对日本政府和分别实施的福岛近海海水监测结果进行比较和分析。参加该机制的研究机构由相关组织选出，包括美国和法国、瑞士、韩国的机构。为保证国际评估的“客观性”，当事国日本没有加入该机制。据日中关系消息人士称，日本政府今年以来多次通过外交渠道敦促中方加入该国际机制，但据悉中方质疑该机制的实效性，认为无法保证分析和评估的独立性等，因此没有接受该建议。日媒宣称，这再次凸显出中方反对核污染水排海的强硬姿态，日本寻求所谓“基于科学根据”的讨论变得“困难”。而一位日本政府消息人士说，中国可能认为加入该框架“相当于支持海洋排放”。此外，日本政府就核污染水向中方提议设置日中专家和实务人士参加的“磋商机制”，但中方对此尚未回应。日，东盟（）相关首脑会议在印尼首都雅加达开幕。日媒称，首相岸田文雄是否与中方接触及讨论核污染水排海问题，成为焦点。不过正式的首脑会谈并未推进协调，很可能不会举行。尽管日媒一再宣传所谓国际机制，但观察者网注意到，韩媒《韩民族日报》曾在月日报道称，核污水排海的安全性争议巨大，但日方却通过各种手段来阻止他国对水质进行独立验证，一直反对韩国等利益相关国家直接取样，并在排海后也坚持这一立场。“如果日本不允许其他国家独立测试，等公众对核污水排海的关注度降低的时候，我毫不怀疑日本会胡乱排放。”韩国核能领域专家李丁润受访时直言。月日，韩联社发文透露，日本东京电力公司当天邀请媒体记者参观福岛核污水排海设施，日方希望通过这样的活动，让媒体帮助其宣传所谓的“海洋排放安全”的观点。在活动现场采访的一位法国记者提议说：“为了提高可信度，让环境团体等第三方机构或专家等参与放射性测定或监测工作怎么样？”然而，负责现场采访说明的东京电力公司职工立即予以否定。他长篇累牍地解释日方测定氚含量的方式，并称“国际原子能机构（）的人正在参与所有监测工作”。韩联社记者写道，“仅凭的监测并不能消除不信任感，这也是有人主张第三方机构或专家参与监测的原因，但是，他（东电职工）好像没听懂似的说了别的东西。”值得注意的是，尹锡悦胜选上台后，新一任韩国政府在对日本核污水排海问题的态度上不断软化。至于美国，尽管美国科学界有不少反对声，但在福岛核污染水排海问题上，拜登政府一直是日本的坚定支持者。中国南海研究院海洋法律与政策研究所副所长丁铎认为，日本是美国的盟友，在福岛核污染水排放问题上，美国政府的考量并不是出于国际社会的公平正义以及子孙后代的福祉，更多是从地缘政治的角度来考虑。“美国在这个问题上公开支持日本，减轻日本的压力，日本也必然会在其他方面对美国投桃报李。”;112;705;817;9387;0.08703526153190583
坚决抵制日本排放核污水日本为非作恶居然还倒打一耙日本把“倒打一耙”“恶人先告状”演绎得淋漓尽致。中方发布的地图将钓鱼岛等地标为中国领土，日方对此提出所谓的抗议，中方自然不会接受，因为钓鱼岛就是中国固有领土，历史经纬很清楚。日本将核污染水强行排海后，中方全面暂停日本水产品进口，中方的做法合理必要，日本不但不反思，还将中方“告上”。加害者居然扮演成受害者的样子“鸣冤叫屈”，“本”在作恶，却恶人先告状，实在可恶看主播说联播央视新闻的微博视频;2;5;7;9387;0.0007457121551081282
邵铁林压载水，是吸进船舱里的用来保持船体平衡状态的水，日本来的船，很可能船舱里的压载水就是核污染水，带到韩国港口排放掉，等于进口核污水了。;1;8833;8834;9387;0.9410887397464579
焦点坊谈超话超话月日，京都的日本人抗议核污水排海。日本将用亿日元处理核污染水负面信息日本已排放超吨核污染水椒哥微记录的微博视频;3;10;13;9387;0.0013848940023436667
为什么全世界都无法阻止日本排放核污水？这个回答脑洞大开。;132;1275;1407;9387;0.14988814317673377
高志凯用一句“把核污水运到挪威岸边排放怎样”？问死了为日本核污水排海辩护的挪威专家。说明所谓日本核污水无害论，真的是美西方基于“立场在先”为同伴辩护的谎言。北京金戈戈的微博视频;17;210;227;9387;0.024182379887077873
高志凯用一句“把核污水运到挪威岸边排放怎样”？问死了为日本核污水排海辩护的挪威专家。此事，说明真理真的是愈辩愈明；也说明所谓日本核污水无害论，真的是美西方基于“立场在先”为同伴辩护的谎言；还说明我们真的应该让更多人进入国际舆论场正面迎战，只要是摆事实、讲道理，无惧任何问题。诸子百家之一的微博视频;12;143;155;9387;0.01651219772025141
日本称为应对中国禁令已砸千亿日元支持排放核污水的人都下地狱已经焦虑死了;1;6;7;9387;0.0007457121551081282
为什么全世界都不能阻止日本核污水排放呢？细思极恐;6;32;38;9387;0.004048151699158411
统派学者纪欣：只要我们抗议不断，日本核污水就排放不了年日本核污水排海海峡导报社的微博视频;1;39;40;9387;0.00426121231490359
日本的核污水排海天了，最让人担心的事还是发生了，网络上几乎没有热度可言了，大家几乎都快忘却了，日本的多亿搞公关，终于看到效果了。甚至已经有一部分人开始怀疑核污水到底有没有毒？如果没毒了，那不是冤枉人家日本了吗？日本是一个淡水资源极度缺乏的国家，淡水对日本很金贵，如果没毒它们会舍得排放？就说喝核污水，为什么不拿来洗衣服、浇花等？这只能说明一个问题：“核污水有毒，不能食用，更不能使用”。如果核污水没毒，为什么日本拒绝其他国家的检测机构对核污水进行采样检测，所有的采样结果都是它们自己公布出来的，它们到底在怕什么？所以现在如果还有人替日本排污洗白，这人他不是蠢就一定是坏了，亿的公关费里肯定有它的一份儿。至于它们作秀的官员，吃福岛的海鲜，一边吃还一边说：“嗯，真好吃真新鲜，那可太好了”。既然这么好吃，你们全留着吃就好了。;4;10;14;9387;0.0014914243102162564
日本必须停止向海里排放核污水。;1;329;330;9387;0.03515500159795462
日本水产品出口要转向欧美？日媒：难日本水产品转售欧美容易吗据日本《朝日新闻》月日报道，受中国全面停止进口日本水产品的影响，日本政府日公布了对水产从业者的援助措施。支柱政策包括“改变出口目的地”“强化国内加工体系”等，主要目的是“摆脱对华依赖”。日本欲将欧美和东南亚定为新的出口目的地，但实现起来面临多重困难。报道称，据日本农林水产省统计，中国是日本最大的水产品出口地，日本水产品加工业也严重依赖中国。此次的援助政策也包括加强日本国内加工体系的措施。但是，日本生产一线的看法并不乐观。在北海道经营水产加工企业的根田俊昭提出质疑：“日本建材价格高涨，机械和电费也在飙升，政府的对策是否具有现实意义？”即便在国内设置了加工点，能否雇到工人也是一大问题。日本政府还计划在欧美等地举办日本食品展销活动。首相岸田文雄将“全球和食热潮”视作开拓出口目的地的动力。但是，实际效果如何目前还不得而知。报道认为，日本食品主要面向中国等亚洲国家出口。虽然欧美市场的规模很大，但饮食文化上的巨大差异还是构成阻碍。而且，一般来说，欧美的卫生法规比亚洲更严格，可能需要更长的时间加以应对。长崎县养殖加工企业“桥口水产”社长桥口直正表示，中国全面停止进口预计将给其造成数亿日元（美元约合日元）的损失。该公司约的鰤鱼出口到海外，其中约销往中国。“公司正处于业务拓展阶段”，桥口直正说，月将正式进入出口季，预计还会造成更大损失。另据法新社月日报道，日本政府已连续多日向太平洋排放福岛核电站的污染水，逾百名来自福岛地区的渔民和市民计划提起诉讼，阻止当局继续排海。报道称，许多日本渔民一直反对核污水排海，担心这会令日本渔业在年大灾难后为改善行业形象所做的多年努力毁于一旦。由福岛和邻近县市的多个渔民和市民组成的抗议联盟，计划月日正式向福岛法院提起诉讼。抗议者发表联合声明称，这是一项错误的政策，因为它无视福岛渔民以及全国各地人民的强烈反对，是绝对无法容忍的举措。（参考消息）;1;6;7;9387;0.0007457121551081282
还是爱夏目友人帐，但日本排放核污水;1;2;3;9387;0.00031959092361776926
核污水请日本政府停止排放核污水一定不能不了了之啊，为了以后的生活一定要抗争到底希望祖国能够联合一切力量，尽快制止日本政府排放核污水;1;1;2;9387;0.0002130606157451795
。。。。？我发现很多人都平等的恨每一个日本人，就好像排放核污水是所有日本人一起放的一样一些同学的发言真的令我大开眼界有个室友今天还说日本很多词怎么都是外来词，全都是偷别人的我寻思外来词用音译不是每个国家都有吗;1;4;5;9387;0.0005326515393629487
航海家的视频核污染导致海洋已变色，座头鲸在痛苦哀叫。日本核污水预计持续排放至年日本核污水天将污染半个太平洋坚决抵制日本排放核污水;1;0;1;9387;0.00010653030787258975
为什么日本决定排放核污水全世界都无法阻止？水是地球唯一的血液如果地球水源流了，地球将会变成一个枯死的地球日本突然声称核污水危害健康张凯华微博的微博视频;4;126;130;9387;0.013848940023436668
棒子国抵制日本法西斯排放核污水，在野党的党首搞绝食，看起来很悲壮是不是？其实很扯淡，你应该拿起枪去杀敌啊，自己折磨自己算个什么玩意呢？日本法西斯都要笑死了。东亚这地方不来场大战，彻底修理修理这些妖魔鬼怪是不行的。;6;65;71;9387;0.007563651858953873
日本，这两字听着就很愤怒。如果不制止排放核污水，未来将会全球癌症大爆发、这辈子吃不了海鲜。欧美是日本核污水排放的同谋，目前只有中国有希望有能力制止日本继续反人类恐袭。日本排放时间要持续年，中国正在采取各种措施制止日本继续反人类罪行。;48;463;511;9387;0.054436987322893364
抵制日本法西斯排放核污水，官方目前能做的也就是禁止核食品进口，主力应该在民间，老百姓主动抵制日货，这才是最重要的，但是胡锡进我们需要管理自己的厌日情绪给民间的抵制力量泼了一盆冷水，彻底浇灭了民间抵制日本法西斯排放核污水的行动。官方做得有限，民间无法行动，那日本法西斯排放核污展开;10;112;122;9387;0.01299669756045595
我一开始就说了，抵制日本法西斯排放核污水的事情会不了了之，现在看基本如此，那接下来，日本法西斯和内部敌特会想方设法把核食品弄进来，搞成了既定事实，手法可能就是泛滥成灾，让你无从查处，会不会出现这种局面？以日本法西斯潜伏的力量完全可以做到。;14;101;115;9387;0.012250985405347822
发现了吗？对于日本的核污水排放，不要争论海鲜还能不能吃了，有一件更重要的事情，大家都忽略了，那么多国家，每年给联合国交了那么多的会费，那么这个时候联合国为什么不站出来主持公道呢？虽然表面说核污水排海没有什么影响，可是不管实际上有没有什么影响，但最起码间接上已经产生很大影响了，比如贸易进口，比如大家不敢吃海鲜等等。，像这种事情日本明明可以偷偷干的，为什么还要大声的报道，非要喊着让全球的人都知道呢？按以往的经验来看，把一件事情抛出来，吸引所有人的目光，目的就是为了在背后偷偷干一些不想让别人知道的事情，比如古代的明修栈道暗度陈仓。，如果越来越多的人不敢吃海鲜了，那么我国那么多渔民靠捕鱼为生，他们没有地可种，难不成七老八十了还出去打工吗？他们以后的生活怎么办？;1;218;219;9387;0.023330137424097154
民众上街反排放，政府大办海鲜节“我们正在经历双重打击，消费低迷，鱼类死亡率上升。”韩国养殖场人员抱怨。信心受损、愤怒难平的不止韩国渔业。铺天盖地的反对声充斥韩国民间。盖洛普韩国月民调显示，的受访者表示不愿意再吃海鲜。超过的韩国人，反对日本排放核污水计划。年新上台的尹锡悦，这次决然站在了民意的对立面。一方面，他领导的政府，对日本的的核污水排海计划表示不反对，另一方面，韩国政府正积极谋划刺激海鲜消费，未来一个月内将在多地推出海鲜节。观察、理解韩国面对核污水时的争端，也许更能理解：是否排污入海，远不止一个实际的工程问题。;7;26;33;9387;0.003515500159795462
月日，日本核污水排放已经持续了天，青岛核辐射值最新出炉青岛市环保局站的检测结果显示，辐射值为，而青岛辖区的三个监测点的辐射值走势基本保持不变，都在安全范围内。大家可以放心啦，不必恐慌。只要小日本还在继续排放核污水，我们就会持续进行监测。当然，也没必要整天盯着这个事情不放，可以放心地生产生活。小编会一直关注这个问题，并及时公布辐射值情况和监测结果，让大家第一时间了解最新信息。随着核污水的排放不断增加，辐射值可能会发生变化。我们应该保持警惕，持续关注辐射数值的变化。小编在此提醒大家，所提供的监测数据均来自国家辐射环境监测网，任何人都不得随意捏造数据，更不能相信谣言或散布谣言。发现青岛美景青岛的代表物青岛四季青岛哪里耍？抖美好青岛青岛头条爆料青岛身边事;3;1;4;9387;0.000426121231490359
为什么全世界都无法阻止日本排放核污水？东京电力有多离谱日本核污染水排海量已超吨;2;11;13;9387;0.0013848940023436667
日媒曝“中国拒绝加入日方建议的核污染水评估国际机制”：再次凸显中方强硬姿态“中国拒绝加入日方建议的处理水评估国际机制。”日媒称，这再次凸显出中方反对核污染水排海的强硬姿态。月日，日本共同社独家报道称，关于东京电力福岛第一核电站核污染水排海，日本政府曾向中方建议加入国际原子能机构（）的所谓国际机制，但中方拒绝。日媒介绍称，该机制由多个国家研究机构组成，将对日本政府和分别实施的福岛近海海水监测结果进行比较和分析。参加该机制的研究机构由相关组织选出，包括美国和法国、瑞士、韩国的机构。为保证国际评估的“客观性”，当事国日本没有加入该机制。据日中关系消息人士称，日本政府今年以来多次通过外交渠道敦促中方加入该国际机制，但据悉中方质疑该机制的实效性，认为无法保证分析和评估的独立性等，因此没有接受该建议。日媒宣称，这再次凸显出中方反对核污染水排海的强硬姿态，日本寻求所谓“基于科学根据”的讨论变得“困难”。而一位日本政府消息人士说，中国可能认为加入该框架“相当于支持海洋排放”。此外，日本政府就核污染水向中方提议设置日中专家和实务人士参加的“磋商机制”，但中方对此尚未回应。日，东盟（）相关首脑会议在印尼首都雅加达开幕。日媒称，首相岸田文雄是否与中方接触及讨论核污染水排海问题，成为焦点。不过正式的首脑会谈并未推进协调，很可能不会举行。尽管日媒一再宣传所谓国际机制，但观察者网注意到，韩媒《韩民族日报》曾在月日报道称，核污水排海的安全性争议巨大，但日方却通过各种手段来阻止他国对水质进行独立验证，一直反对韩国等利益相关国家直接取样，并在排海后也坚持这一立场。“如果日本不允许其他国家独立测试，等公众对核污水排海的关注度降低的时候，我毫不怀疑日本会胡乱排放。”韩国核能领域专家李丁润受访时直言。月日，韩联社发文透露，日本东京电力公司当天邀请媒体记者参观福岛核污水排海设施，日方希望通过这样的活动，让媒体帮助其宣传所谓的“海洋排放安全”的观点。在活动现场采访的一位法国记者提议说：“为了提高可信度，让环境团体等第三方机构或专家等参与放射性测定或监测工作怎么样？”然而，负责现场采访说明的东京电力公司职工立即予以否定。他长篇累牍地解释日方测定氚含量的方式，并称“国际原子能机构（）的人正在参与所有监测工作”。韩联社记者写道，“仅凭的监测并不能消除不信任感，这也是有人主张第三方机构或专家参与监测的原因，但是，他（东电职工）好像没听懂似的说了别的东西。”值得注意的是，尹锡悦胜选上台后，新一任韩国政府在对日本核污水排海问题的态度上不断软化。至于美国，尽管美国科学界有不少反对声，但在福岛核污染水排海问题上，拜登政府一直是日本的坚定支持者。中国南海研究院海洋法律与政策研究所副所长丁铎认为，日本是美国的盟友，在福岛核污染水排放问题上，美国政府的考量并不是出于国际社会的公平正义以及子孙后代的福祉，更多是从地缘政治的角度来考虑。“美国在这个问题上公开支持日本，减轻日本的压力，日本也必然会在其他方面对美国投桃报李。”;8;32;40;9387;0.00426121231490359
排放核污水的日本孤儿们更加垃圾狂四郎青叶真司辣鸡;1;2134;2135;9387;0.22744220730797912
核污水排海香港食安中心检测个日本进口水产辐射水平，全部样本合格香港环境及生态局今日公布，过去一日截至今日中午，食安中心已对个进口日本“水产及其制品、海藻及海盐”的食物样本作辐射水平检测，未发现辐射水平超出安全标准。香港环境及生态局指，渔护署已对个本地渔产品样本作辐射水平检测，全部样本检测合格。天文台亦已加强监测香港水域的环境辐射水平。至目前为止，并没有发现异常情况。环境及生态局又指，由月日起至今日中午，食安中心及渔护署分别检测了共个日本进口食物样本及共个本地渔产品样本作辐射水平检测，全部样本检测合格。香港香港爆料日本核废水排海已经开始影响邻国太平洋沿岸国有权向日本政府发起核污水索赔日本核污染水下午排入海洋日本排放核污水后你还会吃海鲜吗历史会记住日本政府这一笔日本就中国暂停进口水产品向提交文件日本日本正采取卑劣手段对中国倒打一耙日本核污染水排海民众忍无可忍日本水产行业哀鸿遍野网页链接;1;2;3;9387;0.00031959092361776926
海客谈：墨西哥民众称日本核污水排海将影响全人类连日来，日本政府无视公共利益、为一己之私单方面强行启动核污染水排海，遭到日本国内及国际社会的强烈反对和批评。在太平洋的另一侧，拍客来到墨西哥蒙特雷市街头，针对核污水排海一事采访了多位墨西哥民众。他们认为在排放核污水之前，日本政府应该听取其他国家，尤其是环太平洋国家的意见。“我认为日本应该征求其他国家的意见，”当地一名社会活动家说道，“日本排放核污水将对全人类造成影响。”的微博视频;4;73;77;9387;0.00820283370618941
天天硬事期中国禁止日海产品日本已花费超千亿日元疏通关系早知如此何必当初呢美国将彻底从全球霸权的神坛跌落坚决抵制日本排放核污水日本海产品价格暴跌日本不认罪和其文化有关真的很博通的微博视频;5;49;54;9387;0.005752636625119847
胡锡进就是官僚买办阶层的代言人，胡锡进我们需要管理自己的厌日情绪既然这种投降言论都出台了，那说明抵制日本法西斯排放核污水的事情已经告一段落了。;3;233;236;9387;0.02514115265793118
我不是忘了日本排放核污水，我是一点办法也没有，我也不想干着急了;2;2;4;9387;0.000426121231490359
日系车新能源汽车核污水排放，毁的是日系车品牌？最近，我国“抗日情绪”高涨，甚至有人调侃称，一代人有一代人的抗日。之所以会出现这现象，与日本行为息息相关。月日起，日本启动了核污水排海计划。该举动或将威胁人类的生命安全，日本也应该遭到谴责。那么，在汽车行业，日系车会受核污水影响吗？还能买吗？这几年，在电气化浪潮的冲击之下，由于日系车品牌进程缓慢，已经开始走下坡路了。据数据显示年日系车在华销量约为万辆同比下降降幅仅次于韩系车的。而如今国人抵制情绪高涨，日系车品牌或将再次受到影响。而日系车到底能不能买，主要是看产地，看汽车零部件产地是否为福岛。此外，还要看汽车零部件是否可能会使用被核污水污染了的海水。其实，就算汽车不是在福岛生产，也未使用核污水污染的海水，也无法消除部分消费者的疑虑，更无法磨灭国人对日本排核污水的厌恶。因此，唯有日本停止排放核污水，才可能打消大家的后顾之忧。;1;0;1;9387;0.00010653030787258975
日本排放核污水呀，已经成为事实了，愤怒之余也要想想应对的办法，未来对大家的身体要求就更高了。黄帝内经讲，正气存内邪不可干，正气充足的地方啊，外邪就很难入进来了。所以说呀，我们要尽量的提升我们的正气，方法有很多，比如说少熬夜，多晒太阳，饮食的节制，包括正心正念，还是祝大家都健康，都喜乐。;5;4;9;9387;0.0009587727708533077
日本称为应对中国禁令已砸千亿日元日本为核废水买单是自作自受不值得同情和原谅它的排放霍霍的可是全人类日本核废水研究称日本核污水排海天到达中国;3;24;27;9387;0.0028763183125599234
日本称为应对中国禁令已砸千亿日元为什么日本花那么多钱砸钱给核污水擦屁股，而不是把这些钱用于进一步处理核污水。原因我提到过不少次，首要目标是：“千金买马骨”就是要维持一个“低成本排放”，让全世界资本看看他们是如何保护东电的，在日本是可以这样处理危机的，政府是这样保护大财团的。展开;3;31;34;9387;0.0036220304676680515
小笛的追剧日记最近在看我的童年回忆《人鱼的旋律》幼稚但还是觉得好好看讲的是人鱼公主们唱歌拯救世界的故事小时候把每一首歌的歌词都记在小本本上，每一首歌都会唱，喜欢露亚和波音，每集都觉得海斗眼瞎认不出来露亚很讽刺，日本创造的动画片，如果真的有人鱼公主的话，面对排放的核污水也是无能为力的吧;1;2;3;9387;0.00031959092361776926
郭松民：日本核污水排海是一个科学问题吗？一个非常耐人寻味的现象是，日本政府、站在日本政府背后的美国政府、中国国内舆论场的亲日派，都在竭尽全力地把日本向海洋排放核污水这件事，说成是一个纯粹的科学问题。有一个帖子，《从福岛核废水说起：我们在谈科学还是立场》就是从“科学”角展开;6;73;79;9387;0.00841589432193459
最新的消息显示，日本终于在核污水排放问题上做出了重大决策。经过长时间的备受争议和国际压力，日本政府宣布将停止原有的排海行动。这项新政策有望为处理核污水问题带来曙光，给全球环境保护带来重要突破。;1;2;3;9387;0.00031959092361776926
别抢啦别抢啦足够吃的日本排放核污水抢盐囤货张亲亲的微博视频;1;1;2;9387;0.0002130606157451795
网传俄罗斯专家再次建议，用核爆处理福岛核电站前段时间俄罗斯强行派出了一艘名为阿卡德米克费多罗夫的科研船，前往日本核污水排放海域强行进行采样检查。在这之前，日本拒绝任何国家或者第三方国际组织，前往日本核污水排放的近海区域进行海水的采样检测。尤其是对韩国更是趾高气扬，大有一种你敢来取样，我就敢把你赶走的气势在里面。然而俄罗斯一来，日本直接怂了，根本不敢采取任何实质性或过激的行动来阻止或驱赶俄罗斯科研船。也就在这时，中国互联网上又传出来了一个声音，说俄罗斯专家再次建议，用核爆处理福岛核电站拯救人类。最早提出这个说法的是《凤凰卫视》，不过具体是哪个俄罗斯专家说的，这个专家到底存不存在，本虎也不好说，毕竟资料找不到。但是用核爆来抵消核辐射影响的事情，俄罗斯人，或者说是当年的苏联人，确实有过这样的想法。苏联在上世纪年代的时候，曾经提出了和平利用核弹，通过核爆开矿或者挖掘水库的计划。这项计划的名字叫做“国民经济核爆炸”。为了验证这个项目，苏联在哈萨克斯坦用核弹开凿了一个恰刚人工湖。在开凿人工湖的时候，苏联采用了一种低辐射低裂变的核爆炸装置，同时该装置具备“中和”核污水的功能。而这个项目，想必也就是凤凰卫视说的用氢弹炸福岛核电站的说法的来历。现在中国网络都在传这样一个说法，如果俄罗斯测出来核污染海水放射性超标，俄罗斯将会用武力“帮”日本解决这个难题。就是不知道这个说法到底是真是假。;42;269;311;9387;0.033130925748375416
若是特朗普大选获胜成功上台，排放核污水的日本可真要面临大麻烦了。近日，特朗普在演讲中公开嘲讽日本核污水排海的问题，表示日本的核污水中包含有没有经过处理的上百种放射性元素，就算是铜墙铁壁也阻止不了核泄漏，而对于“瞌睡乔”支持日本排放核污水的行为，特朗普也是语言辛辣地表示“希望这穿着纸尿布的家伙喝一杯排泄物，自己衷心祝愿拜登成为绿巨人。”不得不说，特朗普虽然看着作风十分张狂，但是在一些重大问题上却远比拜登和民主党理性、高明得多，正是因为深知核污水对美国也会造成严重损失，所以才会这样言辞激烈地抨击日本核污水排海的行为，显然，一旦特朗普明年成功上台，那么肯定将会对日本索要巨额赔偿，狠狠敲诈日本一笔，到那个时候，失去了美国支持的岸田文雄，可真就是陷入了两边都不是人，四面楚歌的窘境了。最后还是要感慨一下，特朗普是什么人？那可是曾经提倡往身体里注射消毒液来消灭新冠病毒的狠人，但是面对日本核污水依旧如此警惕，由此可见日本核污水的“威力”到底有多大了。;119;640;759;9387;0.08085650367529562
上午英语课，外教让大家一人写下来一个问题问他，有人问他：如何看待日本排放核污水接下来分组起名，有个小组起名叫，外教不理解是什么意思，我真的会笑死;8;14;22;9387;0.0023436667731969747
现在终于知道为什么我不追什么明星了，因为没有德行，不关心社会，不正确引导舆论，那些被外国资本占据了股份的公司那些被收购的草药，那些日本核污水排放很少见那个明行会表达态度的，不过都是自己的利益前程重要;3;4;7;9387;0.0007457121551081282
日本宣称核污水排放入海没问题让我想起了二战时期第一枚原子弹投到广岛的时候，日本也是说只是普通的导弹捏，连内阁会议也没开;1;1;2;9387;0.0002130606157451795
年年想买，年年都搁置，今年终于决定出了新款一定要买，然后日本就排放核污水了，手里的日产本子用着多少都有点膈应。;2;4;6;9387;0.0006391818472355385
月份日本刚排放核污水，不理解地理杂志月刊为什么要登一篇这样的文章;1;0;1;9387;0.00010653030787258975
其实我已懒的废话了，但面对日对大量媒体指责，福岛核污染水排海责任全在中方，不得不将事情的来龙去脉说一下：假如日本侵华期间，那两个受日本“大本营”赏识的军曹，面对严重警告，听那两个佐官的劝告不对一无辜平民加害，我想他们的家乡广岛、长崎可能就不会遭受核击，这两个城市要为这两个混蛋的展开;1;0;1;9387;0.00010653030787258975
核污水排海背后巨大阴谋日本宁花核污染水排海预算倍的亿日元公关，也不执行危害更小的核污水处理方案，美国称日本排放核污水只是幌子，而是为掩盖已拥有制造六千枚核弹的钚日本核污水日本核污染水排海铁军小子的微博视频;5;75;80;9387;0.00852242462980718
日本劫难来了中国停止进口日本海产品，俄罗斯调查日本排放核污水，一旦超标，武力解决，非同小可。普京对日“宣战”俄罗斯要对日本核污水进行检测主持人春笋计划日本核废水排入大海祸害人类快手快手主持人美玲的快手视频;2;11;13;9387;0.0013848940023436667
日本在巴西进行大规模土地购买和移民计划的事情已经曝光。据报道，日本已经秘密购买了超过万平方公里的土地，并且已经有万日本人在那里定居。当时这个消息并没有引起广泛的关注。然而，日本公然排放核污水，现在回顾这个问题，我们不得不惊叹日本早已做好了最坏的打算。巴西已经成为全球第展开;18;169;187;9387;0.019921167572174284
韩国首尔的大学生参加“反对日本人排放核污水”集会阿南的微博视频;1;60;61;9387;0.006498348780227975
日本排放核污水，其目的何在？笔默君的微博视频;15;106;121;9387;0.01289016725258336
惊爆新闻美国竟然采取了一招阴狠至极的手段：大量进口日本海鲜产品，以帮助日本抵消中国禁止进口的巨大损失美国环境部新闻发言人甚至宣称，国际原子能机构已经鉴定日本排放的核污水完全合格，美国政府决定通过这种方式实现“互利互惠”。难道美国真心为日本着想吗？难道他们不怕核污染的海鲜对自己国民健康造成威胁吗？更为令人堪忧的是，是否存在美国通过第三国渠道将这些受污染的海鲜卖给中国的可能性？一想到这个情景，我不禁浑身冒冷汗。这一消息引发了世界范围内的巨大争议和恐慌。人们开始质疑美国政府背后的真实动机，怀疑他们不顾国民健康、只追求自身利益的冷血行为。这样的行为让人无法相信美国政府还有一丝公正和道义。我们呼吁国际社会高度警惕，要求有关部门严查美国的行为，并保护全球人民的身体健康。面对这样的局势，我们也要更加坚定地支持中国政府的决策，保护自己和家人的饮食安全。时刻保持警惕，不受信息的蒙蔽和欺骗，才能守护我们的健康与安全。;1;208;209;9387;0.022264834345371257
有些过于心酸了韩国海盐日本排放核污水张亲亲的微博视频;1;2;3;9387;0.00031959092361776926
金灿荣：日本排放核污水，我们“核平”了它？这是过嘴瘾;1;2;3;9387;0.00031959092361776926
转日本民众称：日本早在年前偷偷排放核污水，全球都在抵制日货。日本称为应对中国禁令已砸千亿日元痞蜀黍的微博视频;2;38;40;9387;0.00426121231490359
现在的紧急事项之一就是要让全世界七十亿人都知道日本正在每分每秒排放核污水进入海洋，还不让第三方进入监测，海洋每分每秒增加多少放射元素的真实数据七十亿地球人有权利清楚。希望小日本尽快在全球不断的施压中停止排放核污水（皇帝的新衣为何是一位小朋友喊出：为什么不穿衣服？，难道富人可以永远吃不到集聚到海洋生物体内的放射元素？），那些干着丧尽天良的恶行之人显然很清楚自己的目的，已经有无数的放射元素进入大海了，而且每分每秒都在增加中，尽早关闭阀门才是唯一出路中国因此制裁它还闹到联合国，个人觉得更好，会让更多的人了解它往大海排放核污水的事实，它可以干着危害全人类的事情却看不惯别人因此制裁它，个人祈祷早日出现如那位成功刺杀安倍晋三的勇士，为地球七十亿人做出个人贡献;3;3;6;9387;0.0006391818472355385
焦点坊谈超话超话韩国最大在野党党首李在明绝食第天，尹锡悦依然无动于衷李在明从月日起开始进行绝食示威，宣誓要反抗“暴政”，匡扶民主。当天是李在明绝食的第天。他的手段并不高明，但他却把矛头指向日本排放核污水和韩国政府的不作为，以此为借口。不过他是在保护自己也好，只要是在抵制日本核污水就应该得到我们的支持。日本将用亿日元处理核污染水负面信息日本已排放超吨核污染水椒哥微记录的微博视频;60;415;475;9387;0.05060189623948013
随手拍日本排放核污水污染海洋，我现在要多吃点怕以后没得吃了;1;1;2;9387;0.0002130606157451795
胡锡进我们需要管理自己的厌日情绪胡锡进请尊重部分国人表达“个人情结”的权力，中国是民主自由的国度，没必要上升到礼仪之邦，对外开放政策的高度济南惨案，九一八事变和七七事变，中国都掀起了抵制日货的浪潮，这是当时所有国人应该有的爱国行动中国人的礼仪和开放包容必须要建立在“平等待我”的前提下，何况日本不仅长期否认侵华战争罪行，更将核污水排放到大海，破坏全球环境和威胁国人健康，而日本某餐馆也挂出针对我们的招牌，难道我们不能对等反制？这样的黑恶国家要允许部分国人“谢绝日本人进入”，否则麻木不仁的中国人就真是“友邦惊诧”;1;2;3;9387;0.00031959092361776926
日本核污水排放或因台风而倒灌，善恶终有报，老天爷都看不下了台风，谢谢宝贝的关注，每日娱乐资讯推送快乐的猩球的微博视频;-6;1;-5;9387;-0.0005326515393629487
谁说特朗普不靠谱？这次特朗普还真的靠谱了一回。特朗普在排放核污水问题上，比拜登靠谱多了，拜登对日本的排核污水采取了毫无原则的纵客态度，而拜登这回则对日本公开进行了声讨，特朗普说：我可以确定，日本的核污水接触过数百种放射性元素，日本处理过？得了吧，即使是铜墙铁壁，也挡不住核泄漏。建国同志在日本排放核污水这件事情上还是有良知的，特朗普的心还是和我们在一起的，在此为特朗普点个赞;22;271;293;9387;0.031213380206668796
老兵带你看世界直击一线情况日本就中国暂停进口水产品向提交文件外交部：中方采取的措施正确、合理且必要网友：绝不妥协，必须还要让日本赔偿中国海洋渔业损失日本排放核污水的影响有多大品茶说酒的微博视频;4;22;26;9387;0.0027697880046873334
很久以后，学生问教师：为什么古人说大海是蓝色的呢？海大海日本排放核污水，谢谢宝贝的关注，每日娱乐资讯推送甜乃奈的微博视频;1;2;3;9387;0.00031959092361776926
月日清晨：日本传来坏消息核污水排海后，检出氚浓度增加五倍。日本政府宣布将核污水排放入大海以来，国内外的反对声音此起彼伏。自年福岛核事故以来，一直有争议围绕着该核电站的处理方式。日本政府表示，他们已经采取了必要的预防措施，并强调称排放核污水是一种安全的方法。然而，随着氚浓度展开;-16;1;-15;9387;-0.0015979546180888463
日本核污水排放的第十四天（补）终于认真开始准备六级了非常充实的一天虽然很累但是很开心很满足今天也要加油哇;1;1;2;9387;0.0002130606157451795
日本称为应对中国禁令已砸千亿日元日本算了个帐，如果深埋核污水需要花费亿日元，排海只花费亿日元。那么因排海造成的损失又是多少呢？仅中国这边公关费亿日元，水产品亿日元，还有日本十个县的其他食品怎么也有上百亿日元。这些加起来已经超过深埋核污水的费用了，而且进出口贸易是持续性损失，什么时候解禁还是未知数。日本出口损失的不仅是中国，美国、东南亚国家都在不同程度的限制，据媒体报道日本的食品基本上都是滞销的，贸易不正常，仅仅靠国际上的情怀，那能出口多少，这些损失难以估算。无论从外交上还是经济上，日本排放核污水都是得不偿失的，这个帐精明的小鬼子能算清楚，但他们依然一意孤行的排放，这到底有什么阴谋？不管是什么，小鬼子就是个祸害，不能不防。;122;853;975;9387;0.10386705017577501
无毒你穿成这样干啥呢娱乐评论大赏日本排放核污水张雪峰，谢谢宝贝的关注，每日娱乐资讯推送甜乃奈的微博视频;1;3;4;9387;0.000426121231490359
日本称为应对中国禁令已砸千亿日元日本排放核污水第十四天;1;11;12;9387;0.001278363694471077
又开始胡说八道了，前面看见好几个让中国人反思的，结果没下文自己坚持不住了，这边又来个让自己管理情绪的，你咋不呼吁美国管理好自己的情绪，不要动不动就制裁？你咋不呼吁日本人管理好情绪，不要动不动抵制中国抗一核污水排放还要告到？老实人活该被欺负，要不再向日本承认个错误？胡锡进我们需要管理自己的厌日情绪日本就中国暂停进口水产品向提交文件;9;9;18;9387;0.0019175455417066154
核污染水排放这多天内，全球瞩目这一问题不仅感到怒火和担忧，因为核污水的排放背离了日本人民，也危害了整个地球，引发全球强烈反对和抗议。科考船驶向福岛周边海域，旨在揭示真相，搞清楚灾难是否已超出我们的想象。日本无法逃避责任。他们的鲁莽和冒险行为不仅伤害了自己，更伤害了整个地球。展开;103;464;567;9387;0.06040268456375839
核污染水排放这多天内，全球瞩目这一问题不仅感到怒火和担忧，因为核污水的排放背离了日本人民，也危害了整个地球，引发全球强烈反对和抗议。科考船驶向福岛周边海域，旨在揭示真相，搞清楚灾难是否已超出我们的想象。日本无法逃避责任。他们的鲁莽和冒险行为不仅伤害了自己，更伤害了整个地球。人们对日本的失望和愤怒已达巅峰，要求其停止核污水排放，并承担应有的责任。栗香派派的微博视频;105;464;569;9387;0.06061574517950357
日本什么时候才能停止排放核污水啊感觉现在每天的生活都是世界末日倒计时，我的爸爸妈妈还没有去过海边，我的爷爷奶奶也还没有去过海边，我还有好多亲人没有来得及见到大海，以后却再也没有办法见到干净的大海了日本核污水超话;1;0;1;9387;0.00010653030787258975
韩国民众举行集会，抗议日本排放核污水，抗议尹锡悦支持日本排放核污水，要求尹锡悦滚回家种田去上帝之鹰的微博视频;14;247;261;9387;0.027804410354745925
日本核污染水排海量已超吨日本计划收购保管受核污水影响水产品日本福岛核污染水排海累计排放量已超吨，随着核污染水排放入海，日本水产品形象严重受损，出口下滑。据日媒报道，日本政府内阁成员会议决定紧急拨款亿日元支援水产业，具体措施包括，临时收购并保管出口受到核污染水排展开;2;1;3;9387;0.00031959092361776926
造什么孽才让我们碰到这些邻居世界破破烂烂造孽日本排放核污水张亲亲的微博视频;0;1;1;9387;0.00010653030787258975
气死人了，小日本股市自排放核污水后，股市连续上涨丝毫不受影响;110;1308;1418;9387;0.15105997656333225
日本民众称：日本早在年前偷偷排放核污水，全球都在抵制日货。日本称为应对中国禁令已砸千亿日元痞蜀黍的微博视频;4;1014;1018;9387;0.10844785341429637
日本称为应对中国禁令已砸千亿日元北京超话上海俄已经派科学家去核污水排放的福岛检测，一旦测出严重超标，大鹅会先小伊万爆了这污染源，然后日本得支付整个项目亿美元的费用及海洋修复及全世界人民的健康修复费用万亿人民币。数年后美元不值钱，因而不说美元;6;48;54;9387;0.005752636625119847
乘日本排放核污水之机，将广东人与日本人联系起来进行诋毁，在未经确认原材料产地情况下歧途搞地域攻击、煽动抵制寿司餐饮行业日本核污染水排海正式开始;1;0;1;9387;0.00010653030787258975
东电为应对风评被害计划扩充体制为应对“风评被害”，东电又出了个大动作日本执意推进核污染水排海的自私行为遭到多方反对，也给自身形象抹了黑。虽然在处理核污染水方面很“算计”，但日方在形象公关方面却很舍得投入。据《日本经济新闻》日报道，东京电力控股公司日发布消息称，为了应对福岛第一核电站排海造成的“风评被害”（形象受损），年内将把应对赔偿和支援开拓销路的相关员工增加到人规模。此前的计划人数约为人。报道称“风评被害”正在日本全国范围内扩大，东京电力打算扩充应对体制。东电常务执行董事吉田贵彦在记者会上表示：“已经接到出口企业和水产企业的数十起咨询。”他还称：“影响可能会波及全日本，将建立起除赔偿外还能解决（开拓销路等）困难的体制。”报道称，针对因中国全面禁止进口日本水产品而受到影响的渔民，东京电力将在日本全国范围内提供开拓销路的支援。此外，还将通过社交网站向海外发布更多信息，实现以多种语言来发布“处理水”开始排海后的检测结果等信息。对核污染水排放的危害，日方好像不太关心，但对自身的“风评被害”却很在意。上月底，日本广播协会（）曾披露，针对社交媒体和其他平台上有关福岛第一核电站核污染水的所谓“虚假信息”，日本外务省制定了加强性应对与传播政策，将为此申请逾亿日元（约合亿人民币）的财政年度预算。这可是一笔不小的“公关预算”，一些网友表示：有这个钱拿来处理核污水不好么？（环球时报）;12;96;108;9387;0.011505273250239693
日本核污染水排海量已超吨日本计划收购保管受核污水影响水产品日本福岛核污染水排海累计排放量已超吨，随着核污染水排放入海，日本水产品形象严重受损，出口下滑。据日媒报道，日本政府内阁成员会议决定紧急拨款亿日元支援水产业，具体措施包括，临时收购并保管出口受到核污染水排海影响的水产品，开拓新的出口目的地等。加上此前已敲定的亿日元基金，累计支援金额达到上千亿日元，约合人民币近亿元。（小央视频）小央视频的微博视频;1;2;3;9387;0.00031959092361776926
日本排放核污水，违了哪些“法”？须担什么“责”？;1;13;14;9387;0.0014914243102162564
东电为应对风评被害又搞大动作：在形象公关方面大投入东电为应对风评被害扩充应对体制据环球时报报道：日本执意推进核污染水排海的自私行为遭到多方反对，也给自身形象抹了黑。虽然在处理核污染水方面很“算计”，但日方在形象公关方面却很舍得投入。据《日本经济新闻》日报道，东京电力控股公司日发布消息称，为了应对福岛第一核电站排海造成的“风评被害”（形象受损），年内将把应对赔偿和支援开拓销路的相关员工增加到人规模。此前的计划人数约为人。报道称“风评被害”正在日本全国范围内扩大，东京电力打算扩充应对体制。东电常务执行董事吉田贵彦在记者会上表示：“已经接到出口企业和水产企业的数十起咨询。”他还称：“影响可能会波及全日本，将建立起除赔偿外还能解决（开拓销路等）困难的体制。”报道称，针对因中国全面禁止进口日本水产品而受到影响的渔民，东京电力将在日本全国范围内提供开拓销路的支援。此外，还将通过社交网站向海外发布更多信息，实现以多种语言来发布“处理水”开始排海后的检测结果等信息。对核污染水排放的危害，日方好像不太关心，但对自身的“风评被害”却很在意。上月底，日本广播协会（）曾披露，针对社交媒体和其他平台上有关福岛第一核电站核污染水的所谓“虚假信息”，日本外务省制定了加强性应对与传播政策，将为此申请逾亿日元（约合亿人民币）的财政年度预算。这可是一笔不小的“公关预算”，一些网友表示：有这个钱拿来处理核污水不好么？;2;1;3;9387;0.00031959092361776926
老兵带你看世界直击一线情况韩最大在野首李在明批尹锡悦当局将为核污染水更名，将向国的老大致信，呼吁各国合力阻止日本排海李在明绝食第五天，促尹锡悦当局向国际法院起诉日本日本排放核污水的影响有多大品茶说酒的微博视频;12;87;99;9387;0.010546500479386385
娱乐综合超话三体果然很有前瞻性叶文洁最初的想法也不是没有道理的，看看日本排放核污水就能理解了明星娱乐综艺搞笑吐槽迷惑行为大赏优质博文上热搜开放计划搞笑总被小朱拒绝的微博视频;1;1;2;9387;0.0002130606157451795
日本排放核污水后的油管评论区阿南的微博视频;4;17;21;9387;0.0022371364653243847
《月日清晨：日本传来坏消息核污水排海后，检出氚浓度增加倍我要上热门日本排放福岛核污染水日本当福岛核电站最新的核污染水检测结果被曝光时，宛如一道震撼的闪电划破宁静的夜空，激起了社交媒体和新闻平台上的热烈讨论。这些检测结果揭示出福岛核电站核污染水排》网页链接;1;0;1;9387;0.00010653030787258975
胡锡进我们需要管理自己的厌日情绪老胡不要把中日两国的国民态度混为一谈。无论从这次排放核污水还是历史事件，日本都是不可宽恕的过错方。我们不忘历史表达自己的愤怒是理所应当，而日本国民的辱华言行必须予以抵制和指责。是非分明这是原则问题，不能用来和稀泥。;6;11;17;9387;0.0018110152338340257
这东西怎么不发去日本让管管核污水排放呢，他死不死啊;1;0;1;9387;0.00010653030787258975
前几日，富士山脚下，中国游客如织，朝日新闻做采访，中游客：挺好的，五年没来了，这里还是那么美中国游客一周花费万日元，主持人惊呼中国人好有钱。日本核污水排放之后，朝日新闻联合东京电视台做了一期外国游客专访，结果在富士山脚下的著名景点，山梨忍野八海，景点停车场数辆大巴，全是中国游客，主持人戏谑的表示，中国游客还是那么多哦现场采访可以看到，中国游客在观光游玩之际，纷纷采购山梨当地特产清酒和桃子。不要再怪外国人歧视中国游客了，你就非要这个时候去日本旅游？搞不懂;13;135;148;9387;0.015766485565143283
胡锡进我们需要管理自己的厌日情绪当初日本兵是普通日本人么？日军的军备供给是普通日本人保障的吗？那些主动劳军的慰安妇是不是有普通日本女人？日本普通人在日本侵略中国的年里哪半点无辜？日本侵略中国烧杀抢捋过去还不足百年，日本排放核污水祸害全球还在持续，为什么要中国老百姓管理厌日情绪？是要国人都数典忘祖吗？;0;10;10;9387;0.0010653030787258974
东电大量招人进行形象公关为应对“风评被害”，东电又出了个大动作日本执意推进核污染水排海的自私行为遭到多方反对，也给自身形象抹了黑。虽然在处理核污染水方面很“算计”，但日方在形象公关方面却很舍得投入。据《日本经济新闻》日报道，东京电力控股公司日发布消息称，为了应对福岛第一核电站排海造成的“风评被害”（形象受损），年内将把应对赔偿和支援开拓销路的相关员工增加到人规模。此前的计划人数约为人。报道称“风评被害”正在日本全国范围内扩大，东京电力打算扩充应对体制。东电常务执行董事吉田贵彦在记者会上表示：“已经接到出口企业和水产企业的数十起咨询。”他还称：“影响可能会波及全日本，将建立起除赔偿外还能解决（开拓销路等）困难的体制。”报道称，针对因中国全面禁止进口日本水产品而受到影响的渔民，东京电力将在日本全国范围内提供开拓销路的支援。此外，还将通过社交网站向海外发布更多信息，实现以多种语言来发布“处理水”开始排海后的检测结果等信息。对核污染水排放的危害，日方好像不太关心，但对自身的“风评被害”却很在意。上月底，日本广播协会（）曾披露，针对社交媒体和其他平台上有关福岛第一核电站核污染水的所谓“虚假信息”，日本外务省制定了加强性应对与传播政策，将为此申请逾亿日元（约合亿人民币）的财政年度预算。这可是一笔不小的“公关预算”，一些网友表示：有这个钱拿来处理核污水不好么？;30;113;143;9387;0.015233834025780334
檀健次超话今天开始和你一起守护海洋檀健次希望日本及时制止自己的错误，停止排放核污水入海，这已经严重危害了世界安全檀健次莫青成檀健次长相思守护海洋檀健次直播檀健次很想很想你檀健次四方馆檀健次元莫檀健次演技檀健次帕拉丁檀健次海洋大使海洋守蔚者保护海洋;9;7;16;9387;0.001704484925961436
终于知道日本为什么要执意排放核污水了正义小黄鸭的微博视频;36;336;372;9387;0.03962927452860339
高晓松超话想让高老师继续开讲系列之愿望清单：新冠对世界的影响俄乌冲突日本排放核污水异域风情之埃及、意大利、土耳其等等这两年离开的大师们有其他感兴趣的话题吗？欢迎继续补充;35;129;164;9387;0.017470970491104718
太尴尬了眼看全世界都对福岛水产品不买单，即使是岸田文雄亲自上阵品尝之后依旧没能起到什么效果，日本政府无奈之下，只能准备将“毒手”强行伸到日本自卫队头上了。近日，日本政府方面表示，日本防卫省和自卫队将优先采购福岛地区的水产品食用。显然，即使是拥有二十多万人的日本自卫队人员全部吃上了福岛水产品，天天吃，顿顿吃，也无法从根本上解决日本水产品滞销的问题，而且未来一旦日本自卫队人员因为长期食用福岛水产品身体健康出现什么问题，对于日本水产品出口又将是沉重打击，反而将更加坚定全世界抵制日本排放核污水以及出口的水产品。日本核污染水排海正式开始日本核污染水下午排入海洋日本政府正式决定福岛核废水排海日本正采取卑劣手段对中国倒打一耙历史会记住日本政府这一笔日本就中国暂停进口水产品向提交文件;20;55;75;9387;0.00798977309044423
逃出大英博物馆历史总是这么惊人的相似：年，中国大陆某些人计划把洛阳、西安、兰州、敦煌、新疆等地所博物馆及研究机构收藏的件丝绸之路的相关珍品国宝，送去日本展览，甚至还要在日本巡回展览到年；年，中国大陆某些人是力排众阻，不顾网友们的多次、长期举报，又把包括兵马俑在内的几百件国宝送去日本展览，某研究院甚至还洋洋得意、十分炫耀；年，中国台湾省某些人把《祭侄文稿》送去日本，至今怀疑有没有被日本调包；年前，日本人以借展为借口，骗走了《西冷八家印存》，至今不归还；年前，日本人故意砸毁了在日本展览的兵马俑，甚至一度不想归还兵马俑碎片；日本侵华时，日本毁掉、抢走了那么多中国文物、古籍，至今不归还。在日本从上到下都极端反华的情况下，在日本排放核污水的情况下，在日本至今都不归还所有中国文物的情况下，在日本曾经故意抢走、骗走、毁坏中国文物的情况下，某些人竟然三番五次、持续不断、大摇大摆、明目张胆、肆无忌惮的往日本送展中国国宝精日们已经到了如此丧心病狂的程度了，到底是谁在做这些精日的保护伞？？“中日友好”、“大棋论”、“冰箱论”已经成了精日、买办阶级、日本人的通行证、护身符。买办阶级、官僚阶级、精日、日本人很早就开始合流了。有些“大棋论”就是典型的精神分裂：一边强行拔高日韩，一边却又在说日韩注定会回归到历史上的小国。在这种“大棋论”的嘴里，未来与日韩的经济合作，仿佛能远超与俄这类真正的大国的合作，仿佛能远超与非洲、欧洲的合作，仿佛与日韩的合作会闪瞎历史、让祖坟冒青烟日本庙、日本医院、日本养老城、日本街、日本人社区、日本人学校日本在侵华时就有的老套路日本一直是“全民间谍”的策略，参考珍珠港事件里那些日料店就是间谍窝。买办阶级一直都在把“养寇自重”给包装成“大棋论”、“冰箱论”、“友邦惊诧论”。;1;5;6;9387;0.0006391818472355385
这样的场面像不像日本排放核污水，真的希望大自然是这样对待小日子的剧综汇精彩影视剪辑影视推荐蛮蛮少女的微博视频;21;89;110;9387;0.011718333865984873
日本福岛县知事视察排海设施称心情复杂：核污水虽稀释但排放量庞大当地时间月日，福岛县知事内堀雅雄走访了东京电力公司福岛第一核电站。他表示，虽然东电声称用海水稀释了核污染水，但面对如此巨量的核污染水排海，他感到心情很复杂。在当天召开的意见交流会上，内堀雅雄要求东电方面认真对待展开;9;112;121;9387;0.01289016725258336
日本福岛县知事视察排海设施称心情复杂：核污水虽稀释但排放量庞大当地时间月日，福岛县知事内堀雅雄走访了东京电力公司福岛第一核电站。他表示，虽然东电声称用海水稀释了核污染水，但面对如此巨量的核污染水排海，他感到心情很复杂。在当天召开的意见交流会上，内堀雅雄要求东电方面认真对待当地民众关于核污染水排海的担忧。看看新闻全球眼的微博视频;13;112;125;9387;0.01331628848407372
刘晓非在抖音群里的言论，南京大学博士汤家凤发文怒怼刘晓非这次日本排放核污水的事刘晓菲又跳出来了他自封为著名国际问题专家，你的专业背景是什么谁封你的你给国家出过哪些非常重要的点子力挽什么狂澜知道你的存在是去年的拼命推销某所谓的神药，医学方面你比我强不了多少，一个号称国际问题专家竟然推销药了，你不感到奇怪今年爆出某医药公司花费巨款贿赂某些人，当然你是否清白你自己知道，这件事之后谁会相信你最近你又是攻击我们驻外的大使，你装得很厉害的样子，以其人之道还治其人之身不懂一个小国都欺负到头上了，我们不反击日本人排放核污水的事你又跳出来了，还口口声声科学，你什么专业的你懂什么既然科学为什么不灌溉农田，不作为园林用水为什么不让其他国家和组织去检测日本人造假还少你就是老百姓口中所谓的“专家”，每人听你嚷嚷啥的;6;31;37;9387;0.003941621391285821
日本核污染水排海量已超吨偷偷减少日本水产进口台学者：美国真的很双标对于日本强行排放核污水入海一事，美国表面上高调支持，背地里却偷偷减少对日本水产品的进口。直新闻的微博视频;1;5;6;9387;0.0006391818472355385
台北随机街访：你对日本核污水排海担心吗？凤凰全球观察团日本福岛核事故产生的污水在国际社会一片质疑声中排入大海。面对日本排放的核污水，台湾岛内民众是否有担忧？他们是否相信日本方面“污水已经达到饮用级别”的说辞？对于“如果污水安全，日本人为什么不喝”的质疑怎么看？凤凰全球观察团台湾观察员走上台北街头随机访问，听听台湾同胞的真实想法日本核污水排海台湾街访凤凰全球观察团寒国人台湾的微博视频;13;113;126;9387;0.013422818791946308
台北随机街访：你对日本核污水排海担心吗？凤凰全球观察团日本福岛核事故产生的污水在国际社会一片质疑声中排入大海。面对日本排放的核污水，台湾岛内民众是否有担忧？他们是否相信日本方面“污水已经达到饮用级别”的说辞？对于“如果污水安全，日本人为什么不喝”的质疑怎么看？凤凰全球观察团展开;13;113;126;9387;0.013422818791946308
